AAA	Công ty Cổ phần Nhựa An Phát Xanh
A32	Công ty cổ phần 32
AAM	Công ty Cổ phần Thủy sản Mekong
AAV	Công ty Cổ phần Việt Tiên Sơn Địa ốc
ABC	Công ty cổ phần Truyền thông VMG
ABI	Công ty Cổ phần Bảo hiểm Ngân hàng Nông nghiệp
ABR	Công ty Cổ phần Đầu tư Nhãn hiệu Việt
ABS	Công ty cổ phần Dịch vụ Nông nghiệp Bình Thuận
ABT	Công ty Cổ phần Xuất nhập khẩu Thủy sản Bến Tre
AC4	Công ty Cổ phần ACC - 244
ACB	Ngân hàng Thương mại Cổ phần Á Châu
ACC	Công ty Cổ phần Đầu tư và Xây dựng Bình Dương ACC
ACE	Công ty Cổ phần Bê tông ly tâm An Giang
ACL	Công ty cổ phần Xuất nhập khẩu Thủy sản Cửu Long An Giang
ACM	CTCP Tập đoàn Khoáng sản Á Cường
ACS	Công ty Cổ phần Xây lắp Thương mại 2
ACV	Tổng công ty Cảng hàng không Việt Nam - CTCP
ADC	Công ty Cổ phần Mĩ thuật và Truyền thông
ADG	Công ty cổ phần Clever Group
ADP	Công ty Cổ phần Sơn Á Đông
ADS	Công ty cổ phần Damsan
AFC	Công ty Cổ phần Nông Lâm Nghiệp Bình Dương
AFX	Công ty Cổ phần Xuất nhập khẩu Nông sản Thực phẩm An Giang
AG1	Công ty Cổ phần 28.1
AGC	Công ty Cổ phần Cà phê An Giang
AGD	Công ty Cổ phần Gò Đàng
AGF	Công ty Cổ phần Xuất nhập khẩu Thủy sản An Giang
AGG	Công ty Cổ phần Đầu tư và Phát triển Bất động sản An Gia
AGM	Công ty cổ phần Xuất nhập khẩu An Giang
AGP	Công ty cổ phần Dược phẩm Agimexpharm
AGR	Công ty Cổ phần Chứng khoán Agribank
AGX	Công ty cổ phần Thực phẩm Nông sản Xuất khẩu Sài Gòn
ALP	Công ty Cổ phần Đầu tư Alphanam
ALT	Công ty Cổ phần Văn hóa Tân Bình
ALV	Công ty Cổ phần Đầu tư phát triển Hạ tầng ALV
AMC	Công ty cổ phần Khoáng sản Á Châu
AMD	Công ty cổ phần Đầu tư và Khoáng sản FLC Stone
AME	Công ty Cổ phần Alphanam E&C
AMP	Công ty Cổ phần Armephaco
AMS	Công ty Cổ phần Cơ khí xây dựng AMECC
AMV	CTCP Sản xuất Kinh doanh Dược và Trang thiết bị Y tế Việt Mỹ
ANC11601	Trái Phiếu Công ty Cổ phần Dinh dưỡng Nông nghiệp Quốc tế
ANT	CTCP Rau quả Thực phẩm An Giang
ANV	Công ty Cổ phần Nam Việt
APC	Công ty Cổ phần Chiếu xạ An Phú
APF	Công ty Cổ phần Nông sản thực phẩm Quảng Ngãi
APG	Công ty Cổ phần Chứng khoán APG
APH	Công ty Cổ phần Tập đoàn An Phát Holdings
API	Công ty Cổ phần Đầu tư Châu Á - Thái Bình Dương
APL	CTCP Cơ khí và Thiết bị áp lực - VVMI
APP	Công ty Cổ phần Phát triển Phụ gia và Sản phẩm Dầu mỏ
APS	Công ty Cổ phần Chứng khoán Châu Á – Thái Bình Dương
APT	CTCP Kinh doanh Thủy Hải Sản Sài Gòn
AQN	Công ty cổ phần 28 Quảng Ngãi
ARM	Công ty Cổ phần Xuất nhập khẩu Hàng không
ART	Công ty Cổ phần Chứng khoán BOS
ASA	Công ty cổ phần Tập đoàn ASA
ASD	Công ty Cổ phần Sông Đà Hà Nội
ASIAGF	Quỹ đầu tư tăng trưởng ACB
ASM	Công ty Cổ phần Tập đoàn Sao Mai
ASP	Công ty Cổ phần Tập đoàn Dầu khí An Pha
AST	Công ty Cổ phần Dịch vụ Hàng không Taseco
ATA	Công ty Cổ phần NTACO
ATB	Công ty Cổ phần An Thịnh
ATD	Công ty cổ phần 28 Đà Nẵng
ATG	Công ty Cổ phần An Trường An
ATS	Công ty cổ phần Suất ăn công nghiệp Atesco
AUM	CTCP Vinacafe Sơn Thành
AVC	Công ty cổ phần Thuỷ điện A Vương
AVF	Công ty Cổ phần Việt An
AVS	Công ty Cổ phần Chứng khoán Âu Việt
B82	Công ty Cổ phần 482
BAB	Ngân hàng Thương mại cổ phần Bắc Á
BAL	Công ty cổ phần Bao bì Bia – Rượu – Nước giải khát
BAM	CTCP Khoáng sản và Luyện kim Bắc Á
BAS	Công ty Cổ phần Basa
BAX	Công ty Cổ phần Thống Nhất
BBC	Công ty Cổ phần Bibica
BBM	Công ty Cổ phần Bia Hà Nội - Nam Định
BBS	Công ty cổ phần VICEM Bao bì Bút Sơn
BBT	Công ty Cổ phần Bông Bạch Tuyết
BCB	Công ty cổ phần 397
BCC	Công ty Cổ phần Xi măng Bỉm Sơn
BCE	Công ty Cổ phần Xây dựng và Giao thông Bình Dương
BCF	Công ty Cổ phần Thực phẩm Bích Chi
BCG	Công ty cổ phần Bamboo Capital
BCI	Công ty Cổ phần Đầu tư Xây dựng Bình Chánh
BCM	Tổng Công ty Đầu tư và phát triển Công nghiệp - CTCP
BCP	Công ty cổ phần Dược Becamex
BDB	Công ty Cổ phần Sách và Thiết bị Bình Định
BDC	Tổng Công ty Xây dựng Bạch Đằng - CTCP
BDF	Công ty cổ phần Giày Bình Định
BDG	CTCP May mặc Bình Dương
BDP	Công ty Cổ phần Biệt thự và Khách sạn biển Đông Phương
BDT	Công ty Cổ phần Xây lắp và Vật liệu Xây dựng Đồng Tháp
BDW	Công ty cổ phần Cấp thoát nước Bình Định
BED	Công ty Cổ phần Sách và Thiết bị trường học Đà Nẵng
BEL	CTCP Điện tử Biên Hòa
BFC	Công ty cổ phần Phân bón Bình Điền
BGM	Công ty Cổ phần Khai thác và Chế biến Khoáng sản Bắc Giang
BGW	Công ty Cổ phần Nước sạch Bắc Giang
BHA	Công ty Cổ phần Thủy điện Bắc Hà
BHC	Công ty Cổ phần Bê tông Biên Hòa
BHG	Công ty TNHH MTV Chè Biển Hồ
BHK	Công ty Cổ phần Bia Hà Nội - Kim Bài
BHN	Tổng CTCP Bia - Rượu - Nước giải khát Hà Nội
BHP	Công ty Cổ phần Bia Hà Nội - Hải Phòng
BHS	Công ty Cổ phần Đường Biên Hòa
BHT	Công ty Cổ phần Đầu tư Xây dựng Bạch Đằng TMC
BHV	Công ty Cổ phần Viglacera Bá Hiến
BIC	Tổng Công ty Cổ phần Bảo hiểm Ngân hàng Đầu tư và phát triển Việt Nam
BID	Ngân hàng Thương mại cổ phần Đầu tư và Phát triển Việt Nam
BII	Công ty cổ phần Đầu tư và Phát triển Công nghiệp Bảo Thư
BIO	Công ty cổ phần Vắc xin và Sinh phẩm Nha Trang
BKC	Công ty Cổ phần Khoáng sản Bắc Kạn
BKH	Công ty cổ phần Bánh Mứt Kẹo Hà Nội
BLF	Công ty Cổ phần Thủy sản Bạc Liêu
BLI	Tổng Công ty cổ phần Bảo hiểm Bảo Long
BLN	CTCP Vận tải và Dịch vụ Liên Ninh
BLT	Công ty Cổ phần Lương thực Bình Định
BLU	Trung tâm Dịch vụ Đô thị tỉnh Bạc Liêu
BLW	Công ty cổ phần Cấp nước Bạc Liêu
BM9	CTCP Đầu tư Xây dựng 319 Miền Nam
BMC	Công ty cổ phần Khoáng sản Bình Định
BMD	Công ty Cổ phần Môi trường và Dịch vụ đô thị Bình Thuận
BMF	Công ty cổ phần Vật liệu Xây dựng và Chất đốt Đồng Nai
BMG	Công ty cổ phần May Bình Minh
BMI	Tổng Công ty Cổ phần Bảo Minh
BMJ	Công ty Cổ phần Khoáng sản Miền Đông AHP
BMN	Công ty Cổ phần 715
BMP	Công ty Cổ phần Nhựa Bình Minh
BMS	Công ty Cổ phần Chứng khoán Bảo Minh
BMV	Công ty Cổ phần Bột mỳ Vinafood 1
BNW	Công ty cổ phần Nước sạch Bắc Ninh
BOT	Công ty cổ phần BOT Cầu Thái Hà
BPC	Công ty cổ phần Vicem Bao bì Bỉm Sơn
BPW	Công ty Cổ phần Cấp thoát nước Bình Phước
BQB	Công ty Cổ phần Bia Hà Nội - Quảng Bình
BRC	Công ty Cổ phần Cao su Bến Thành
BRR	Công ty Cổ phần Cao su Bà Rịa
BRS	Công ty Cổ phần Dịch vụ đô thị Bà Rịa
BSA	Công ty cổ phần Thủy điện Buôn Đôn
BSC	Công ty Cổ phần Dịch vụ Bến Thành
BSD	Công ty Cổ phần Bia Rượu Sài Gòn - Đồng Xuân
BSG	Công ty Cổ phần Xe khách Sài Gòn
BSH	Công ty cổ phần Bia Sài Gòn - Hà Nội
BSI	Công ty cổ phần Chứng khoán Ngân hàng Đầu tư và Phát triển Việt Nam
BSL	Công ty Cổ phần Bia Sài Gòn - Sông Lam
BSP	Công ty cổ phần Bia Sài Gòn - Phú Thọ
BSQ	Công ty cổ phần Bia Sài Gòn - Quảng Ngãi
BSR	Công ty Cổ phần Lọc Hóa dầu Bình Sơn
BST	Công ty Cổ phần Sách - Thiết bị Bình Thuận
BT1	Công ty cổ phần Bảo vệ Thực vật 1 Trung ương
BT6	Công ty Cổ phần Beton 6
BTB	Công ty Cổ phần Bia Hà Nội - Thái Bình
BTC	Công ty Cổ phần Cơ khí và Xây dựng Bình Triệu
BTD	Công ty Cổ phần Bê tông Ly tâm Thủ Đức
BTG	Công ty Cổ phần Bao bì Tiền Giang
BTH	Công ty Cổ phần Chế tạo Biến thế và Vật liệu điện Hà Nội
BTN	Công ty Cổ phần Gạch Tuy Nen Bình Định
BTP	Công ty Cổ phần Nhiệt điện Bà Rịa
BTR	CTCP Đường sắt Bình Trị Thiên
BTS	Công ty cổ phần Xi măng Vicem Bút Sơn
BTT	Công ty Cổ phần Thương mại - Dịch vụ Bến Thành
BTU	CTCP Công trình Đô thị Bến Tre
BTV	Công ty Cổ phần Dịch vụ Du lịch Bến Thành
BTW	Công ty Cổ phần Cấp nước Bến Thành
BUD	CTCP Khoa học Công nghệ Việt Nam
BVG	Công ty Cổ phần Đầu tư BVG
BVH	Tập đoàn Bảo Việt
BVN	Công ty cổ phần Bông Việt Nam
BVS	Công ty Cổ phần Chứng khoán Bảo Việt
BWA	Công ty Cổ phần Cấp thoát nước và Xây dựng Bảo Lộc
BWE	Công ty Cổ phần Nước – Môi trường Bình Dương
BWS	Công ty cổ phần Cấp nước Bà Rịa - Vũng Tàu
BXD	Công ty Cổ phần Vận tải và Quản lý Bến xe Đà Nẵng
BXH	Công ty cổ phần VICEM Bao bì Hải Phòng
BXT	Ban Quản lý và Điều hành Bến xe tàu
C12	Công ty Cổ phần Cầu 12
C21	Công ty cổ phần Thế kỷ 21
C22	Công ty Cổ phần 22
C32	Công ty Cổ phần Đầu tư Xây dựng 3-2
C36	Công ty Cổ phần Quản lý và Xây dựng công trình giao thông 236
C47	Công ty Cổ phần Xây dựng 47
C4G	Công ty cổ phần Tập đoàn CIENCO4
C69	Công ty Cổ phần Xây dựng 1369
C71	Công ty Cổ phần 471
C92	Công ty Cổ phần Xây dựng và Đầu tư 492
CAB	CTCP Tổng Công ty Truyền hình Cáp Việt Nam
CAD	Công ty Cổ phần Chế biến và Xuất nhập khẩu Thủy sản CADOVIMEX
CAG	Công ty Cổ phần Cảng An Giang
CAM	Công ty TNHH MTV Môi trường đô thị Cà Mau
CAN	Công ty Cổ phần Đồ hộp Hạ Long
CAP	Công ty Cổ phần Lâm Nông sản Thực phẩm Yên Bái
CAT	Công ty Cổ phần Thủy sản Cà Mau
CAV	Công ty cổ phần Dây Cáp Điện Việt Nam
CBC	Công ty cổ phần Chè Bàu Cạn
CBI	Công ty Cổ phần Gang thép Cao Bằng
CBS	Công ty Cổ phần Mía đường Cao Bằng
CC1	Tổng Công ty Xây dựng số 1 - CTCP
CC4	Công ty Cổ phần Đầu tư và Xây dựng số 4
CCA	CTCP Xuất nhập khẩu Thủy sản Cần Thơ
CCH	Công ty Cổ phần Tư vấn và Đầu tư xây dựng CCIC Hà Nội
CCI	Công ty Cổ phần Đầu tư Phát triển Công nghiệp - Thương mại Củ Chi
CCL	Công ty cổ phần Đầu tư và Phát triển Đô thị Dầu khí Cửu Long
CCM	Công ty Cổ phần Khoáng sản & Xi măng Cần Thơ
CCP	Công ty cổ phần Cảng Cửa Cấm Hải Phòng
CCR	Công ty cổ phần Cảng Cam Ranh
CCT	Công ty Cổ phần Cảng Cần Thơ
CCV	Công ty cổ phần Tư vấn Xây dựng Công nghiệp và Đô thị Việt Nam
CDC	Công ty Cổ phần Chương Dương
CDG	Công ty Cổ phần Cầu Đuống
CDH	CTCP Công trình công cộng Dịch vụ Du lịch Hải Phòng
CDN	Công ty cổ phần Cảng Đà Nẵng
CDO	Công ty Cổ phần Tư vấn thiết kế và Phát triển đô thị
CDP	Công ty cổ phần Dược phẩm Trung ương Codupha
CDR	Công ty Cổ phần Xây dựng Cao su Đồng Nai
CE1	Công ty Cổ phần Xây dựng và Thiết bị Công nghiệp CIE1
CEC	Công ty Cổ phần Thiết kế Công nghiệp Hóa chất
CEE	Công ty Cổ phần Xây dựng Hạ tầng CII
CEG	Công ty Cổ phần Tập đoàn Xây dựng và Thiết bị Công nghiệp
CEN	Công ty Cổ phần Dịch vụ Hàng không CENCON Việt Nam
CEO	Công ty Cổ phần Tập đoàn C.E.O
CER	Công ty Cổ phần Địa chính và Tài nguyên Môi trường
CET	Công ty cổ phần Tech-Vina
CFC	Công ty Cổ phần Cafico Việt Nam
CFV	Công ty TNHH Một thành viên Cà phê Thắng Lợi
CGP	Công ty cổ phần Dược phẩm Cần Giờ
CGV	Công ty Cổ phần Sành sứ Thủy tinh Việt Nam
CH5	Công ty Cổ phần Xây dựng Số 5 Hà Nội
CHC	Công ty Cổ phần Cẩm Hà
CHP	Công ty Cổ phần Thủy điện miền Trung
CHS	Công ty Cổ phần Chiếu sáng Công cộng Thành phố Hồ Chí Minh
CI5	Công ty cổ phần Đầu tư Xây dựng số 5
CIA	Công ty Cổ phần Dịch vụ Sân bay Quốc tế Cam Ranh
CIC	Công ty Cổ phần Đầu tư và Xây dựng COTEC
CID	Công ty Cổ phần Xây dựng và Phát triển Cơ sở Hạ tầng
CIG	Công ty Cổ phần COMA18
CII	Công ty cổ phần Đầu tư Hạ tầng Kỹ thuật T.P Hồ Chí Minh
CII11709	Trái phiếu Công ty Cổ phần Đầu tư Hạ tầng Kỹ thuật Thành phố Hồ Chí Minh
CII41401	Trái phiếu chuyển đổi Công ty cổ phần Đầu tư Hạ tầng Kỹ thuật Thành phố Hồ Chí Minh
CIP	Công ty Cổ phần Xây lắp và Sản xuất Công nghiệp
CJC	Công ty Cổ phần Cơ điện Miền Trung
CK8	Công ty Cổ phần Cơ khí 120
CKA	Công ty cổ phần Cơ khí An Giang
CKD	Công ty cổ phần Cơ khí Đông Anh Licogi
CKG	CTCP Tập đoàn Tư vấn Đầu tư & Xây dựng Kiên Giang
CKH	Công ty Cổ phần Cơ khí chế tạo Hải Phòng
CKV	Công ty Cổ phần COKYVINA
CLC	Công ty Cổ phần Cát Lợi
CLG	Công ty Cổ phần Đầu tư và Phát triển Nhà đất COTEC
CLH	Công ty cổ phần Xi măng La Hiên VVMI
CLL	Công ty cổ phần Cảng Cát Lái
CLM	CTCP Xuất nhập khẩu Than - Vinacomin
CLP	Công ty Cổ phần Thủy Sản Cửu Long
CLS	Công ty Cổ phần Chứng Khoán Chợ Lớn
CLW	Công ty Cổ phần Cấp nước Chợ Lớn
CLX	Công ty Cổ phần Xuất nhập khẩu và Đầu tư Chợ Lớn (Cholimex)
CMC	Công ty Cổ phần Đầu tư CMC
CMD	CTCP Vật liệu Xây dựng và Trang trí Nội thất Thành phố Hồ Chí Minh
CMF	Công ty Cổ phần Thực phẩm Cholimex
CMG	Công ty Cổ phần Tập đoàn Công nghệ CMC
CMI	Công ty cổ phần CMISTONE Việt Nam
CMK	Công ty cổ phần Cơ khí Mạo khê - Vinacomin
CMN	Công ty Cổ phần Lương thực Thực phẩm Colusa-Miliket
CMP	CTCP Cảng Chân Mây
CMS	Công ty cổ phần Xây dựng và Nhân lực Việt Nam
CMT	Công ty Cổ phần Công nghệ Mạng và Truyền thông
CMV	Công ty Cổ phần Thương nghiệp Cà Mau
CMW	Công ty Cổ phần Cấp nước Cà Mau
CMX	Công ty Cổ phần Camimex Group
CNC	Công ty cổ phần Công nghệ cao Traphaco
CNG	Công ty cổ phần CNG Việt Nam
CNH	Công ty Cổ phần Cảng Nha Trang
CNN	CTCP Tư vấn công nghệ thiết bị và kiểm định xây dựng - CONINCO
CNT	Công ty Cổ phần Xây dựng và Kinh doanh Vật tư
COM	Công ty Cổ phần Vật tư - Xăng dầu
CPA	CTCP Cà phê Phước An
CPC	Công ty Cổ phần Thuốc sát trùng Cần Thơ
CPH	Công ty Cổ phần Mai táng Hải Phòng
CPI	Công ty Cổ phần Đầu tư Cảng Cái Lân
CPW	CTCP Công trình Giao thông Công chánh
CQT	Công ty cổ phần Xi măng Quán Triều VVMI
CRC	Công ty Cổ phần Create Capital Việt Nam
CRE	Công ty Cổ phần Bất động sản Thế Kỷ
CSC	Công ty Cổ phần Tập đoàn COTANA
CSG	Công ty Cổ phần Cáp Sài Gòn
CSI	Công ty cổ phần Chứng khoán Kiến thiết Việt Nam
CSM	Công ty Cổ phần Công nghiệp Cao su Miền Nam
CSV	Công ty Cổ phần Hóa chất Cơ bản miền Nam
CT3	Công ty Cổ phần Đầu tư và Xây dựng Công trình 3
CT5	Công ty cổ phần 319.5
CT6	Công ty Cổ phần Công trình 6
CTA	Công ty Cổ phần Vinavico
CTB	Công ty Cổ phần Chế tạo Bơm Hải Dương
CTC	Công ty cổ phần Gia Lai CTC
CTD	Công ty Cổ phần Xây dựng Coteccons
CTF	Công ty cổ phần City Auto
CTG	Ngân hàng Thương mại Cổ phần Công thương Việt Nam
CTI	Công ty Cổ phần Đầu tư Phát triển Cường Thuận IDICO
CTM	Công ty Cổ phần Đầu tư Xây dựng và Khai thác mỏ Vinavico
CTN	Công ty Cổ phần Xây dựng Công trình ngầm
CTP	Công ty Cổ phần Minh Khang Capital Trading Public
CTR	Tổng Công ty Cổ phần Công trình Viettel
CTS	Công ty cổ phần Chứng khoán Ngân hàng Công thương Việt Nam
CTT	CTCP Chế tạo máy Vinacomin
CTV	Công ty cổ phần Đầu tư-Sản xuất và Thương mại Việt Nam
CTW	CTCP Cấp thoát nước Cần Thơ
CTX	Tổng Công ty Cổ phần Đầu tư Xây dựng và Thương mại Việt Nam
CVC	Công ty Cổ Phần Cơ điện Vật tư
CVH	Công ty Cổ phần Công viên Cây xanh Hải Phòng
CVN	Công ty cổ phần Vinam
CVT	Công ty Cổ phần CMC
CX8	Công ty cổ phần Đầu tư và Xây lắp Constrexim số 8
CXH	CTCP Xe khách Hà Nội
CYC	Công ty Cổ phần Gạch men Chang Yih
CZC	Công ty cổ phần Than miền Trung
D11	Công ty Cổ phần Địa ốc 11
D26	Công ty Cổ phần Quản lý và Xây dựng Đường bộ 26
D2D	Công ty Cổ phần Phát triển Đô thị Công nghiệp Số 2
DAC	Công ty Cổ phần Viglacera Đông Anh
DAD	Công ty Cổ phần Đầu tư và Phát triển Giáo dục Đà Nẵng
DAE	Công ty Cổ phần Sách Giáo dục tại Tp. Đà Nẵng
DAG	Công ty Cổ phần Tập đoàn Nhựa Đông Á
DAH	Công ty cổ phần Tập đoàn Khách sạn Đông Á
DAP	Công ty Cổ phần Đông Á
DAR	Công ty Cổ phần Xe lửa Dĩ An
DAS	Công ty Cổ phần Máy - Thiết bị Dầu khí Đà Nẵng
DAT	Công ty Cổ phần Đầu tư Du lịch và Phát triển Thủy sản
DBC	Công ty Cổ phần Tập đoàn Dabaco Việt Nam
DBD	Công ty Cổ phần Dược - Trang thiết bị Y tế Bình Định
DBH	CTCP Đường bộ Hải Phòng
DBM	Công ty Cổ phần Dược - Vật tư Y tế Đăk Lăk
DBT	Công ty Cổ phần Dược phẩm Bến Tre
DBW	Công ty Cổ phần Cấp nước Điện Biên
DC1	Công ty cổ phần Đầu tư Phát triển Xây dựng số 1
DC2	Công ty Cổ phần Đầu tư Phát triển - Xây dựng số 2
DC4	Công ty Cổ phần DIC số 4
DCC	Công ty Cổ phần Xây dựng Công nghiệp DESCON
DCD	CTCP Du lịch và Thương mại DIC
DCF	Công ty Cổ phần Xây dựng và Thiết kế số 1
DCG	Công ty cổ phần Tổng công ty May Đáp Cầu
DCH	Công ty Cổ phần Địa chính Hà Nội
DCI	Công ty Cổ phần Công nghiệp Hóa chất Đà Nẵng
DCL	Công ty Cổ phần Dược phẩm Cửu Long
DCM	Công ty Cổ phần Phân bón Dầu khí Cà Mau
DCR	Công ty cổ phần Gạch men Cosevco
DCS	Công ty Cổ phần Tập đoàn Đại Châu
DCT	Công ty Cổ phần Tấm lợp Vật liệu xây dựng Đồng Nai
DDG	Công ty cổ phần Đầu tư Công nghiệp Xuất nhập khẩu Đông Dương
DDH	CTCP Đảm bảo giao thông đường thủy Hải Phòng
DDM	Công ty Cổ phần Hàng hải Đông Đô
DDN	Công ty Cổ phần Dược - Thiết bị Y tế Đà Nẵng
DDV	Công ty cổ phần DAP - VINACHEM
DFC	Công ty Cổ phần Xích líp Đông Anh
DFS	CTCP Chế biến Xuất nhập khẩu Nông sản Thực phẩm Đồng Nai
DGC	Công ty Cổ phần Tập đoàn Hóa chất Đức Giang
DGL	CTCP Hóa chất Đức Giang – Lào Cai
DGT	Công ty cổ phần Công trình Giao thông Đồng Nai
DGW	Công ty cổ phần Thế giới số
DHA	Công ty Cổ phần Hóa An
DHB	Công ty Cổ phần Phân đạm và Hóa chất Hà Bắc
DHC	Công ty Cổ phần Đông Hải Bến Tre
DHD	Công ty cổ phần Dược Vật tư Y tế Hải Dương
DHG	Công ty Cổ phần Dược Hậu Giang
DHI	Công ty cổ phần In Diên Hồng
DHL	Công ty cổ phần Cơ khí Vận tải Thương mại Đại Hưng
DHM	Công ty cổ phần Thương mại và khai thác khoáng sản Dương Hiếu
DHN	Công ty Cổ phần Dược phẩm Hà Nội
DHP	Công ty Cổ phần Điện Cơ Hải Phòng
DHT	Công ty Cổ phần Dược phẩm Hà Tây
DIC	Công ty Cổ phần Đầu tư và Thương mại DIC
DID	Công ty Cổ phần DIC - Đồng Tiến
DIG	Tổng Công ty Cổ phần Đầu tư Phát triển Xây dựng
DIH	Công ty Cổ phần Đầu tư Phát triển Xây dựng - Hội An
DKH	Trung tâm Đăng kiểm phương tiện Giao thông Thủy bộ
DKP	Công ty cổ phần Dược khoa
DL1	Công ty Cổ phần Đầu tư Phát triển Dịch vụ Công trình Công cộng Đức Long Gia Lai
DLC	Công ty cổ phần Du lịch Cần Thơ
DLD	Công ty Cổ phần Du lịch Đắk Lắk
DLG	Công ty Cổ phần Tập đoàn DLG
DLR	Công ty Cổ phần Địa ốc Đà Lạt
DLT	CTCP Du lịch và Thương mại – Vinacomin
DLV	Công ty Cổ phần Du lịch Việt Nam Vitours
DM7	Công ty cổ phần Dệt may 7
DMC	Công ty Cổ phần Xuất nhập khẩu Y tế Domesco
DNA	Công ty Cổ phần Điện nước An Giang
DNB	Công ty TNHH MTV Sách và Thiết bị trường học tỉnh Đắk Nông
DNC	Công ty Cổ phần Điện nước Lắp máy Hải Phòng
DND	CTCP Đầu tư Xây dựng và Vật liệu Đồng Nai
DNE	Công ty Cổ phần Môi trường Đô thị Đà Nẵng
DNF	Công ty Cổ phần Lương thực Đà Nẵng
DNH	Công ty Cổ phần Thủy điện Đa Nhim - Hàm Thuận - Đa Mi
DNL	Công ty cổ phần Logistic Cảng Đà Nẵng
DNM	Tổng Công ty cổ phần Y tế Danameco
DNN	Công ty Cổ phần Cấp nước Đà Nẵng
DNP	Công ty Cổ phần Nhựa Đồng Nai
DNR	CTCP Đường sắt Quảng Nam - Đà Nẵng
DNS	Công ty Cổ phần Thép Đà Nẵng
DNT	Công ty Cổ phần Du lịch Đồng Nai
DNW	Công ty cổ phần Cấp nước Đồng Nai
DNY	Công ty Cổ phần Thép Dana - Ý
DOC	Công ty cổ phần Vật tư nông nghiệp Đồng Nai
DOP	CTCP Vận tải Xăng dầu Đồng Tháp
DP1	Công ty Cổ phần dược phẩm Trung ương CPC1
DP2	Công ty Cổ phần Dược phẩm Trung ương 2
DP3	Công ty Cổ phần Dược phẩm Trung ương 3
DPC	Công ty Cổ phần Nhựa Đà Nẵng
DPG	Công ty Cổ phần Đạt Phương
DPH	Công ty Cổ phần Dược phẩm Hải Phòng
DPM	Tổng Công ty Phân bón và Hóa chất Dầu khí-CTCP
DPP	Công ty Cổ phần Dược Đồng Nai
DPR	Công ty Cổ phần Cao su Đồng Phú
DPS	Công ty cổ phần Đầu tư Phát triển Sóc Sơn
DQC	Công ty Cổ phần Bóng đèn Điện Quang
DRC	Công ty Cổ phần Cao su Đà Nẵng
DRG	Công ty cổ phần Cao su Đắk Lắk
DRH	Công ty cổ phần DRH Holdings
DRI	Công ty Cổ phần Đầu tư Cao su Đắk Lắk
DRL	Công ty Cổ phần Thủy điện – Điện lực 3
DS3	Công ty Cổ phần Quản lý Đường sông số 3
DSC	Công ty Cổ phần Chứng khoán Đà Nẵng
DSG	Công ty Cổ phần Kính Viglacera Đáp Cầu
DSN	Công ty Cổ phần Công viên nước Đầm Sen
DSP	Công ty cổ phần Dịch vụ Du lịch Phú Thọ
DSS	Công ty Cổ phần Đường sắt Sài Gòn
DST	Công ty Cổ phần Đầu tư Sao Thăng Long
DSV	Công ty Cổ phần Đường sắt Vĩnh Phú
DT4	CTCP Quản lý bảo trì đường thủy nội địa số 4
DTA	Công ty Cổ phần Đệ Tam
DTB	Công ty cổ phần Công trình Đô thị Bảo Lộc
DTC	Công ty Cổ phần Viglacera Đông Triều
DTD	Công ty Cổ phần Đầu tư phát triển Thành Đạt
DTG	Công ty Cổ phần Dược phẩm Tipharco
DTI	Công ty Cổ phần Đầu tư Đức Trung
DTK	Tổng công ty Điện lực TKV - CTCP
DTL	Công ty Cổ phần Đại Thiên Lộc
DTN	Công ty Cổ phần Diêm Thống Nhất
DTT	Công ty Cổ phần Kỹ nghệ Đô Thành
DTV	Công ty Cổ phần Phát triển điện Nông thôn Trà Vinh
DUS	CTCP Dịch vụ Đô thị Đà Lạt
DVC	Công ty cổ phần Thương mại Dịch vụ Tổng hợp Cảng Hải Phòng
DVD	Công ty Cổ phần Dược phẩm Viễn Đông
DVH	Công ty cổ phần Chế tạo máy điện Việt Nam - Hungari
DVN	Tổng Công ty Dược Việt Nam - CTCP
DVP	Công ty cổ phần Đầu tư và Phát triển Cảng Đình Vũ
DVW	Công ty Cổ phần Dịch vụ và Xây dựng Cấp nước Đồng Nai
DWS	Công ty cổ phần Cấp nước và Môi trường đô thị Đồng Tháp
DX2	Công ty cổ phần Đầu tư và Xây dựng 319.2
DXG	Công ty Cổ phần Tập đoàn Đất Xanh
DXL	Công ty Cổ phần Du lịch và Xuất nhập khẩu Lạng Sơn
DXP	Công ty cổ phần Cảng Đoạn Xá
DXV	Công ty Cổ phần VICEM Vật liệu Xây dựng Đà Nẵng
DZM	Công ty Cổ phần Chế tạo máy Dzĩ An
E12	CTCP Xây dựng điện Vneco12
E1SSHN30	Chứng chỉ quỹ ETF SSIAM-HNX30
E1VFVN30	Quỹ ETF VFMVN30
E29	CTCP Đầu tư xây dựng và kỹ thuật 29
EAD	CTCP Thủy điện Điện lực Đắk Lắk
EBA	Công ty Cổ phần Điện Bắc Nà
EBS	Công ty Cổ phần Sách Giáo dục tại Tp.Hà Nội
ECI	Công ty Cổ phần Bản đồ và Tranh ảnh Giáo dục
EFI	Công ty Cổ phần Đầu tư Tài chính Giáo dục
EIB	Ngân hàng Thương mại Cổ phần Xuất nhập khẩu Việt Nam
EIC	Công ty cổ phần EVN Quốc tế
EID	Công ty Cổ phần Đầu tư và Phát triển giáo dục Hà Nội
EIN	Công ty cổ phần Đầu tư - Thương mại - Dịch vụ Điện lực
ELC	Công ty Cổ phần Đầu tư Phát triển Công nghệ Điện tử Viễn thông
EMC	Công ty cổ phần Cơ điện Thủ Đức
EME	Công ty Cổ phần Điện cơ
EMG	Công ty Cổ phần Thiết bị Phụ tùng Cơ điện
EMS	Tổng Công ty Chuyển phát nhanh Bưu Điện - CTCP
EPC	Công ty TNHH Một thành viên Cà phê Ea Pốk
EPH	Công ty Cổ phần dịch vụ xuất bản giáo dục Hà Nội
EVE	Công ty cổ phần Everpia
EVF	Công ty Tài chính cổ phần Điện lực
EVG	Công ty Cổ phần Đầu tư Everland
EVS	Công ty cổ phần Chứng khoán Everest
FBA	Công ty Cổ phần Tập đoàn Quốc tế FBA
FBC	Công ty Cổ phần Cơ khí Phổ Yên
FBT	Công ty Cổ phần Xuất nhập khẩu Lâm Thủy sản Bến Tre
FCC	CTCP Liên hợp Thực phẩm
FCM	Công ty cổ phần Khoáng sản FECON
FCN	Công ty cổ phần FECON
FCS	Công ty Cổ phần Lương thực Thành phố Hồ Chí Minh
FDC	Công ty Cổ phần Ngoại thương và Phát triển Đầu tư Thành phố Hồ Chí Minh
FDG	Công ty Cổ phần Docimexco
FDT	Công ty cổ phần Fiditour
FGL	Công ty cổ phần Cà phê Gia Lai
FHN	Công Ty Cổ phần Xuất Nhập Khẩu Lương Thực - Thực Phẩm Hà Nội
FHS	Công ty cổ phần Phát hành sách T.P Hồ Chí Minh
FIC	Tổng công ty Vật Liệu Xây Dựng Số 1 - CTCP
FID	Công ty Cổ phần Đầu tư và Phát triển Doanh nghiệp Việt Nam
FIR	Công ty Cổ phần Địa ốc First Real
FIT	Công ty cổ phần Tập đoàn F.I.T
FLC	Công ty cổ phần Tập đoàn FLC
FMC	Công ty Cổ phần Thực phẩm Sao Ta
FOC	Công ty cổ phần Dịch vụ Trực tuyến FPT
FOX	Công ty Cổ phần Viễn thông FPT
FPC	Công ty Cổ phần Full Power
FPT	Công ty Cổ phần FPT
FRC	Công ty cổ phần Lâm đặc sản Xuất khẩu Quảng Nam
FRM	Công ty cổ phần Lâm nghiệp Sài Gòn
FRT	Công ty cổ phần Bán lẻ Kỹ thuật số FPT
FSC	Công ty Cổ phần Chứng khoán Yuanta Việt Nam
FSO	Công ty Cổ phần Cơ khí đóng tàu thủy sản Việt Nam
FT1	Công ty Cổ phần Phụ tùng máy số 1
FTI	Công ty Cổ phần Công nghiệp - Thương mại Hữu Nghị
FTM	Công ty Cổ phần Đầu tư và Phát triển Đức Quân
FTS	Công ty Cổ phần Chứng khoán FPT
FTV	Công ty Cổ phần Công nghiệp Ngũ Kim Fortress
FUCTVGF1	Quỹ Đầu tư tăng trưởng TVAM
FUCTVGF2	Quỹ Đầu tư tăng trưởng Thiên Việt 2
FUCVREIT	Quỹ Đầu tư Bất động sản Techcom Việt Nam
FUESSV50	Quỹ ETF SSIAM VNX50
FUESSVFL	Quỹ ETF SSIAM VNFIN LEAD
G20	Công ty cổ phần Đầu tư Dệt may G.Home
G36	Tổng Công ty 36 - CTCP
GAB	Công ty Cổ phần Đầu tư khai khoáng và Quản lý tài sản FLC
GAS	Tổng Công ty Khí Việt Nam-CTCP
GBS	Công ty Cổ phần Chứng khoán Golden Bridge Việt Nam
GCB	Công ty Cổ Phần Petec Bình Định
GDT	Công ty Cổ phần Chế biến Gỗ Đức Thành
GDW	Công ty Cổ phần Cấp nước Gia Định
GEG	Công ty cổ phần Điện Gia Lai
GER	Công ty Cổ phần Thể thao Ngôi sao Geru
GEX	Tổng Công ty cổ phần Thiết bị điện Việt Nam
GFC	Công ty Cổ phần Thủy sản Gentraco
GGG	Công ty cổ phần Ô tô Giải Phóng
GGS	Công ty Cổ phần Giống Gia súc Hà Nội
GHA	Công ty Cổ phần HAPACO Hải Âu
GHC	Công ty Cổ phần Thủy điện Gia Lai
GIL	Công ty Cổ phần Sản xuất Kinh doanh Xuất nhập khẩu Bình Thạnh
GKM	Công ty Cổ phần Khang Minh Group
GLC	Công ty cổ phần Vàng Lào Cai
GLT	Công ty cổ phần Kỹ thuật điện Toàn Cầu
GLW	Công ty Cổ phần Cấp thoát nước Gia Lai
GMC	Công ty Cổ phần Sản xuất Thương mại May Sài Gòn
GMD	Công ty Cổ phần Gemadept
GMX	Công ty cổ phần Gạch Ngói Gốm Xây dựng Mỹ Xuân
GND	Công ty Cổ phần Gạch ngói Đồng Nai
GQN	Trung tâm Giống Thủy sản Quảng Nam
GSM	Công ty cổ phần Thủy điện Hương Sơn
GSP	Công ty cổ phần Vận tải Sản phẩm khí quốc tế
GTA	Công ty Cổ phần Chế biến Gỗ Thuận An
GTC	Công ty Cổ phần Trà Rồng Vàng
GTD	Công ty Cổ phần Giầy Thượng Đình
GTH	Công ty Cổ phần Xây dựng Giao thông Thừa Thiên Huế
GTK	Công ty cổ phần Giầy Thụy Khuê
GTN	Công ty cổ phần GTNfoods
GTS	CTCP Công trình Giao thông Sài Gòn
GTT	Công ty Cổ phần Thuận Thảo
GVR	Tập đoàn Công nghiệp Cao su Việt Nam
GVT	Công ty Cổ phần Giấy Việt Trì
H11	Công ty Cổ phần Xây dựng HUD101
HAB	Công ty Cổ phần Sách và Thiết bị Trường học Hà Nội
HAC	Công ty Cổ phần Chứng khoán Hải Phòng
HAD	Công ty Cổ phần Bia Hà Nội - Hải Dương
HAF	Công ty Cổ phần Thực phẩm Hà Nội
HAG	Công ty Cổ phần Hoàng Anh Gia Lai
HAH	Công ty Cổ phần Vận tải và Xếp dỡ Hải An
HAI	Công ty Cổ phần Nông dược H.A.I
HAM	Công ty Cổ phần Vật tư Hậu Giang
HAN	Tổng công ty Xây dựng Hà Nội - CTCP
HAP	Công ty Cổ phần Tập đoàn Hapaco
HAR	Công ty Cổ phần Đầu tư Thương mại Bất động sản An Dương Thảo Điền
HAS	Công ty Cổ phần HACISCO
HAT	Công ty Cổ phần Thương mại Bia Hà Nội
HAV	Công ty Cổ phần rượu Hapro
HAX	Công ty Cổ phần Dịch vụ Ô tô Hàng Xanh
HBB	Ngân hàng Thương mại Cổ phần Nhà Hà Nội
HBC	Công ty cổ phần Tập đoàn Xây dựng Hoà Bình
HBD	Công ty Cổ phần Bao bì PP Bình Dương
HBE	Công ty Cổ phần Sách - Thiết bị trường học Hà Tĩnh
HBH	Công ty Cổ phần Habeco - Hải Phòng
HBI	Công ty Cổ phần HBI
HBS	Công ty Cổ phần Chứng khoán Hòa Bình
HBW	Công ty cổ phần Nước sạch Hòa Bình
HC1	CTCP Xây dựng số 1 Hà Nội
HC3	Công ty Cổ phần Xây dựng Số 3 Hải Phòng
HCB	Công ty cổ phần Dệt may 29/3
HCC	Công ty Cổ phần Bê tông Hoà Cầm - Intimex
HCD	Công ty Cổ phần Đầu tư Sản xuất và Thương mại HCD
HCI	Công ty Cổ phần Đầu tư - Xây dựng Hà Nội
HCM	Công ty Cổ phần Chứng khoán Thành phố Hồ Chí Minh
HCS	Công ty Cổ phần Thông tin Tín hiệu Đường sắt Hà Nội
HCT	Công ty Cổ phần Thương mại Dịch vụ Vận tải Xi măng Hải Phòng
HD2	CTCP Đầu tư Phát triển nhà HUD2
HD3	CTCP Đầu tư Phát triển Nhà và Đô thị MHDI3
HD8	CTCP Đầu tư Phát triển Nhà và Đô thị HUD8
HDA	Công ty Cổ phần Hãng sơn Đông Á
HDB	Ngân hàng TMCP Phát triển T.P Hồ Chí Minh
HDC	Công ty Cổ phần Phát triển nhà Bà Rịa-Vũng Tàu
HDG	Công ty Cổ phần Tập đoàn Hà Đô
HDM	Công ty Cổ phần Dệt May Huế
HDO	Công ty Cổ phần Hưng Đạo Container
HDP	Công ty Cổ phần Dược Hà Tĩnh
HDW	Công ty cổ phần Kinh doanh nước sạch Hải Dương
HEC	Công ty Cổ phần Tư vấn Xây dựng Thủy lợi II
HEJ	Tổng Công ty Tư vấn xây dựng Thủy lợi Việt Nam - Công ty Cổ phần
HEM	Công ty cổ phần Chế tạo Điện Cơ Hà Nội
HEP	Công ty Cổ phần Môi trường và Công trình Đô thị Huế
HES	Công ty Cổ phần Dịch vụ Giải trí Hà Nội
HEV	Công ty Cổ phần Sách Đại học - Dạy nghề
HFB	Công ty Cổ phần Công trình Cầu phà Thành phố Hồ Chí Minh
HFC	Công ty Cổ phần Xăng dầu HFC
HFS	Công ty Cổ phần Thương mại dịch vụ Thời trang Hà Nội
HFT	Công ty Cổ phần Chứng khoán Pinetree
HFX	Công ty cổ phần Sản xuất - Xuất nhập khẩu Thanh Hà
HGA	Trung tâm Giống Nông nghiệp tỉnh Hậu Giang
HGC	Trung tâm Quy hoạch - Kiến trúc tỉnh Hậu Giang
HGM	Công ty cổ phần Cơ khí và Khoáng sản Hà Giang
HGW	Công ty Cổ phần Cấp thoát nước - Công trình đô thị Hậu Giang
HHA	Công ty cổ phần Văn phòng phẩm Hồng Hà
HHC	Công ty Cổ phần Bánh kẹo Hải Hà
HHG	Công ty Cổ phần Hoàng Hà
HHL	Công ty Cổ phần Hồng Hà Long An
HHN	Công ty Cổ Phần Vận tải và Dịch vụ Hàng hóa Hà Nội
HHP	Công ty cổ phần Giấy Hoàng Hà Hải Phòng
HHR	Công ty Cổ phần Đường sắt Hà Hải
HHS	Công ty Cổ phần Đầu tư Dịch vụ Hoàng Huy
HHV	CTCP Đầu tư hạ tầng giao thông Đèo Cả
HID	Công ty Cổ phần Halcom Việt Nam
HIG	Công ty Cổ phần Tập đoàn HIPT
HII	Công ty Cổ phần An Tiến Industries
HIZ	Công ty cổ phần Khu công nghiệp Hố Nai
HJC	Công ty Cổ phần Hòa Việt
HJS	Công ty Cổ phần Thủy điện Nậm Mu
HKB	Công ty Cổ phần Nông nghiệp và Thực phẩm Hà Nội - Kinh Bắc
HKP	CTCP Bao bì Hà Tiên
HKT	Công ty Cổ phần Đầu tư EGO Việt Nam
HLA	Công ty Cổ phần Hữu Liên Á Châu
HLB	Công ty Cổ phần Bia và Nước giải khát Hạ Long
HLC	CTCP Than Hà Lầm - Vinacomin
HLD	Công ty Cổ phần Đầu tư và Phát triển Bất động sản HUDLAND
HLE	Công ty Cổ phần Điện chiếu sáng Hải Phòng
HLG	Công ty Cổ phần Tập đoàn Hoàng Long
HLR	Công ty Cổ phần Đường sắt Hà Lạng
HLS	Công ty Cổ phần Sứ kỹ thuật Hoàng Liên Sơn
HLT	CTCP Dệt may Hoàng Thị Loan
HLY	Công ty Cổ phần Viglacera Hạ Long I
HMC	Công ty Cổ phần Kim khí Thành phố Hồ Chí Minh - Vnsteel
HMG	CTCP Kim khí Hà Nội - VNSTEEL
HMH	Công ty Cổ phần Hải Minh
HMS	Công ty Cổ phần Xây dựng bảo tàng Hồ Chí Minh
HNA	Công ty Cổ phần Thủy điện Hủa Na
HNB	CTCP Bến xe Hà Nội
HND	CTCP Nhiệt điện Hải Phòng
HNE	Công ty cổ phần Hanel
HNF	CTCP Thực phẩm Hữu Nghị
HNG	Công ty cổ phần Nông nghiệp Quốc tế Hoàng Anh Gia Lai
HNI	Công ty Cổ phần May Hữu Nghị
HNM	Công ty Cổ phần Sữa Hà Nội
HNP	Công ty Cổ phần Hanel Xốp nhựa
HNR	Công ty Cổ phần Cồn rượu Hà Nội
HNT	Công ty Cổ phần Xe điện Hà Nội
HOM	Công ty cổ phần Xi măng VICEM Hoàng Mai
HOT	Công ty cổ phần Du lịch - Dịch vụ Hội An
HPB	Công ty Cổ phần Bao bì PP
HPC	Công ty Cổ phần Chứng khoán Hải Phòng
HPD	Công ty Công ty Cổ phần Thủy điện Đăk Đoa
HPG	Công ty cổ phần Tập đoàn Hòa Phát
HPH	Công ty Cổ phần Hóa chất Hưng Phát Hà Bắc
HPI	Công ty Cổ phần Khu công nghiệp Hiệp Phước
HPL	Công ty Cổ phần Bến xe Tàu phà Cần Thơ
HPM	CTCP Xây dựng Thương mại và Khoáng sản Hoàng Phúc
HPP	Công ty Cổ phần Sơn Hải Phòng
HPR	Công ty Cổ phần Đầu tư Xây dựng Hồng Phát
HPS	Công ty Cổ phần Đá Xây dựng Hoà Phát
HPT	Công ty Cổ phần Dịch vụ Công nghệ Tin học HPT
HPU	Công ty cổ phần 28 Hưng Phú
HPW	Công ty Cổ phần Cấp nước Hải Phòng
HPX	Công ty cổ phần Đầu tư Hải Phát
HQC	Công ty cổ phần Tư vấn-Thương mại-Dịch vụ Địa ốc Hoàng Quân
HRB	Công ty Cổ phần Harec Đầu tư và Thương mại
HRC	Công ty Cổ phần Cao su Hòa Bình
HRG	Công ty cổ phần Cao su Hà Nội
HRT	Công ty cổ phần Vận tải Đường sắt Hà Nội
HSA	Công ty Cổ phần HESTIA
HSC	Công ty Cổ phần Hacinco
HSG	Công ty Cổ phần Tập đoàn Hoa Sen
HSI	Công ty Cổ phần Vật tư tổng hợp và Phân bón Hóa sinh
HSL	Công ty Cổ phần Chế biến Nông sản Hồng Hà Sơn La
HSM	Tổng Công ty cổ phần Dệt may Hà Nội
HSP	CTCP Sơn Tổng hợp Hà Nội
HST	Công ty cổ phần Phát hành Sách và Thiết bị Trường học Hưng Yên
HT1	Công ty Cổ phần Xi Măng Vicem Hà Tiên
HT2	Công ty Cổ phần Xi măng Hà Tiên 2
HTB	Công ty Cổ phần Xây dựng Huy Thắng
HTC	Công ty Cổ phần Thương mại Hóc Môn
HTE	Công ty Cổ phần Đầu tư Kinh doanh Điện lực Thành phố Hồ Chí Minh
HTG	Tổng Công ty cổ phần Dệt may Hòa Thọ
HTI	Công ty Cổ phần Đầu tư phát triển hạ tầng IDICO
HTK	Trung tâm Đăng kiểm xe cơ giới Hải Dương
HTL	Công ty Cổ phần Kỹ thuật và Ô tô Trường Long
HTM	Tổng Công ty Thương mại Hà Nội - CTCP
HTN	Công ty Cổ phần Hưng Thịnh Incons
HTP	Công ty Cổ phần In sách giáo khoa Hòa Phát
HTR	Công ty Cổ phần Đường sắt Hà Thái
HTT	Công ty cổ phần Thương mại Hà Tây
HTU	Công ty Cổ phần Môi trường và Công trình Đô thị Hà Tĩnh
HTV	Công ty Cổ phần Vận tải Hà Tiên
HTW	Công ty Cổ phần Cấp nước Hà Tĩnh
HU1	Công ty Cổ phần Đầu tư và Xây dựng HUD1
HU3	Công ty cổ phần Đầu tư và Xây dựng HUD3
HU4	Công ty Cổ phần Đầu tư và Xây dựng HUD4
HU6	Công ty cổ phần Đầu tư Phát triển nhà và Đô thị HUD 6
HUB	Công ty cổ phần Xây lắp Thừa Thiên Huế
HUG	Tổng Công ty may Hưng Yên - Công ty Cổ phần
HUT	Công ty Cổ phần Tasco
HVA	Công ty cổ phần Đầu tư HVA
HVC	Công ty Cổ phần Hưng Vượng
HVG	Công ty Cổ phần Hùng Vương
HVH	Công ty Cổ phần Đầu tư và Công nghệ HVC
HVN	Tổng Công ty Hàng không Việt Nam - CTCP
HVT	Công ty Cổ phần Hóa chất Việt Trì
HVX	Công ty Cổ phần Xi măng Vicem Hải Vân
HWS	Công ty cổ phần Cấp nước Thừa Thiên Huế
I10	CTCP Đầu tư Xây dựng số 10 IDICO
I40	Công ty Cổ phần Đầu tư và Xây dựng 40
IBC	Công ty Cổ phần Đầu tư Apax Holdings
IBD	CTCP In Tổng hợp Bình Dương
ICC	CTCP Xây dựng Công nghiệp
ICF	Công ty Cổ phần Đầu tư Thương mại Thủy Sản
ICG	Công ty Cổ phần Xây dựng Sông Hồng
ICI	Công ty Cổ phần Đầu tư và Xây dựng Công nghiệp
ICN	Công ty cổ phần Đầu tư Xây dựng Dầu khí IDICO
ICT	Công ty cổ phần Viễn thông - Tin học Bưu điện
IDC	Tổng công ty IDICO - Công ty Cổ phần
IDI	Công ty Cổ phần Đầu tư và Phát triển Đa Quốc Gia I.D.I
IDJ	Công ty cổ phần đầu tư IDJ Việt Nam
IDN	Công ty cổ phần In và Dịch vụ Đà Nẵng
IDV	Công ty Cổ phần Phát triển Hạ tầng Vĩnh Phúc
IFC	CTCP Thực phẩm Công nghệ Sài Gòn
IFS	Công ty Cổ phần Thực phẩm Quốc tế
IHK	Công ty Cổ phần In Hàng không
IJC	Công ty Cổ phần Phát triển Hạ tầng Kỹ thuật
IKH	Công ty Cổ phần In Khoa học Kỹ thuật
ILA	Công ty Cổ phần ILA
ILB	Công ty Cổ phần ICD Tân Cảng – Long Bình
ILC	Công ty Cổ phần Hợp tác Lao động với Nước ngoài
ILS	Công ty Cổ phần Đầu tư Thương mại và Dịch vụ Quốc tế
IME	Công ty Cổ phần Cơ khí và Xây lắp Công nghiệp
IMP	Công ty Cổ phần Dược phẩm IMEXPHARM
IMT	Công ty Cổ phần Xuất nhập khẩu Đầu tư Thành phố Hồ Chí Minh
IN4	Công ty Cổ phần In số 4
INC	Công ty Cổ phần Tư vấn Đầu tư IDICO
INN	Công ty Cổ phần Bao bì và In Nông nghiệp
IPA	Công ty cổ phần Tập đoàn Đầu tư I.P.A
IPH	Công ty TNHH MTV In và Phát hành biểu mẫu Thống kê
IRC	Công ty Cổ phần Cao su Công nghiệp
ISG	CTCP Vận tải biển & Hợp tác Quốc tế
ISH	Công ty cổ phần Thủy điện Srok Phu Miêng IDICO
IST	Công ty Cổ phần ICD Tân Cảng Sóng Thần
ITA	Công ty Cổ phần Đầu tư và Công nghiệp Tân Tạo
ITC	Công ty Cổ phần Đầu tư - Kinh doanh nhà
ITD	Công ty Cổ phần Công nghệ Tiên Phong
ITQ	Công ty cổ phần Tập đoàn Thiên Quang
ITS	Công ty cổ phần Đầu tư Thương mại và Dịch vụ - Vinacomin
IVS	Công ty cổ phần Chứng khoán Đầu tư Việt Nam
JOS	Công ty Cổ phần Chế biến Thủy sản Xuất khẩu Minh Hải
JSC	Công ty Cổ phần Xây dựng Cầu đường Hà Nội
JVC	Công ty cổ phần Thiết bị Y tế Việt Nhật
KAC	Công ty Cổ phần Đầu tư Địa ốc Khang An
KBC	Tổng Công ty Phát triển Đô thị Kinh Bắc-CTCP
KBE	Công ty Cổ phần Sách - Thiết bị Trường học Kiên Giang
KBT	Công ty Cổ phần Gạch ngói Kiên Giang
KCB	CTCP Khoáng sản và luyện kim Cao Bằng
KCE	Công ty Cổ phần Bê tông Ly tâm Điện lực Khánh Hòa
KDC	Công ty Cổ phần Tập đoàn Kido
KDF	Công ty Cổ phần Thực phẩm Đông lạnh KIDO
KDH	Công ty Cổ phần Đầu tư Kinh doanh nhà Khang Điền
KDM	Công ty Cổ phần Đầu tư HP Việt Nam
KGM	Công ty Cổ phần Xuất nhập khẩu Kiên Giang
KGU	Công ty Cổ phần Phát triển Đô thị Kiên Giang
KHA	Công ty Cổ phần Đầu tư và Dịch vụ Khánh Hội
KHB	Công ty Cổ phần Khoáng sản Hòa Bình
KHD	CTCP Khai thác Chế biến khoáng sản Hải Dương
KHL	Công ty cổ phần Khoáng sản và Vật liệu Xây dựng Hưng Long
KHP	Công ty Cổ phần Điện lực Khánh Hòa
KHS	Công ty Cổ phần Kiên Hùng
KHW	Công ty Cổ phần Cấp nước Khánh Hòa
KIP	Công ty Cổ phần K.I.P Việt Nam
KKC	Công ty Cổ phần Kim khí KKC
KLB	Ngân hàng TMCP Kiên Long
KLF	Công ty Cổ phần Đầu tư Thương mại và Xuất nhập khẩu CFS
KLM	CTCP Kim loại màu Nghệ Tĩnh
KLS	Công ty Cổ phần Chứng khoán Kim Long
KMF	Công ty Cổ phần Mirae Fiber
KMR	Công ty Cổ phần Mirae
KMT	Công ty cổ phần Kim khí miền Trung
KOS	Công ty Cổ phần Kosy
KPF	Công ty Cổ phần Đầu tư tài chính Hoàng Minh
KSA	Công ty Cổ phần Công nghiệp Khoáng sản Bình Thuận
KSB	Công ty Cổ phần Khoáng sản và Xây dựng Bình Dương
KSC	Công ty Cổ phần Muối Khánh Hòa
KSD	Công ty cổ phần Đầu tư DNA
KSE	Công ty Cổ phần Xuất khẩu Thủy sản Khánh Hòa
KSH	Công ty Cổ phần Damac GLS
KSK	Công ty cổ phần Khoáng sản Luyện kim màu
KSQ	Công ty cổ phần CNC Capital Việt Nam
KSS	Công ty Cổ phần Khoáng sản Na Rì Hamico
KST	Công ty cổ phần KASATI
KSV	Tổng Công ty Khoáng sản TKV - CTCP
KTB	Công ty Cổ phần Đầu tư Khoáng sản Tây Bắc
KTC	Công ty Cổ phần Thương mại Kiên Giang
KTL	CTCP Kim khí Thăng Long
KTS	Công ty cổ phần Đường Kon Tum
KTT	Công ty cổ phần Đầu tư Thiết bị và Xây lắp điện Thiên Trường
KTU	Công ty Cổ phần Môi trường đô thị Kon Tum
KVC	CTCP Sản xuất Xuất nhập khẩu Inox Kim Vĩ
L10	Công ty cổ phần Lilama 10
L12	Công ty cổ phần Licogi 12
L14	Công ty cổ phần LICOGI 14
L18	Công ty Cổ phần Đầu tư và Xây dựng số 18
L35	Công ty Cổ phần Cơ khí Lắp máy Lilama
L43	Công ty Cổ phần Lilama 45.3
L44	Công ty Cổ phần Lilama 45.4
L45	CTCP Lilama 45.1
L61	Công ty Cổ phần Lilama 69-1
L62	Công ty Cổ phần Lilama 69-2
L63	CTCP Lilama 69-3
LAF	Công ty Cổ phần Chế biến Hàng xuất khẩu Long An
LAI	CTCP Đầu tư xây dựng Long An IDICO
LAS	Công ty cổ phần Supe Phốt phát và Hóa chất Lâm Thao
LAW	Công ty cổ phần Cấp thoát nước Long An
LBC	Công ty Cổ phần Thương mại - Đầu tư Long Biên
LBE	Công ty Cổ phần Sách và Thiết bị trường học Long An
LBM	Công ty Cổ phần Khoáng sản và Vật liệu xây dựng Lâm Đồng
LCC	Công ty Cổ phần Xi măng Hồng Phong
LCD	Công ty Cổ phần Lắp máy - Thí nghiệm Cơ điện
LCG	Công ty cổ phần LICOGI 16
LCM	Công ty Cổ phần Khai thác và Chế biến Khoáng sản Lào Cai
LCS	Công ty Cổ phần Licogi 166
LCW	Công ty Cổ phần Nước sạch Lai Châu
LDG	Công ty Cổ phần Đầu tư LDG
LDP	Công ty Cổ phần Dược Lâm Đồng - Ladophar
LDW	Công ty TNHH MTV Cấp thoát nước Lâm Đồng
LEC	Công ty Cổ phần Bất động sản Điện lực Miền Trung
LG9	Công ty Cổ phần Cơ giới và Xây lắp số 9
LGC	Công ty Cổ phần Đầu tư Cầu đường CII
LGL	Công ty cổ phần Đầu tư và Phát triển Đô thị Long Giang
LGM	CTCP Giày da và May mặc Xuất khẩu (LEGAMEX)
LHC	Công ty Cổ phần Đầu tư và Xây dựng Thủy lợi Lâm Đồng
LHG	Công ty Cổ phần Long Hậu
LIC	Tổng Công ty Licogi - Công ty Cổ phần
LIG	Công ty Cổ phần Licogi 13
LIX	Công ty Cổ phần Bột giặt Lix
LKW	CTCP Cấp nước Long Khánh
LLM	Tổng Công ty Lắp máy Việt Nam - CTCP
LM3	Công ty Cổ phần Lilama 3
LM7	Công ty Cổ phần Lilama 7
LM8	Công ty Cổ phần Lilama 18
LMC	Công ty Cổ phần Khoáng sản Latca
LMH	Công ty Cổ phần Landmark Holding
LMI	Công ty Cổ phần Đầu tư Xây dựng Lắp máy IDICO
LNC	Công ty cổ phần Lệ Ninh
LO5	Công ty Cổ phần Lilama 5
LPB	Ngân hàng TMCP Bưu điện Liên Việt
LQN	Công ty cổ phần Licogi Quảng Ngãi
LSS	Công ty Cổ phần Mía đường Lam Sơn
LTC	Công ty cổ phần Điện nhẹ Viễn thông
LTG	Công ty Cổ phần Tập đoàn Lộc Trời
LUT	Công ty Cổ phần Đầu tư Xây dựng Lương Tài
LWS	Công ty Cổ phần Cấp nước tỉnh Lào Cai
M10	Tổng Công ty May 10 - CTCP
MAC	Công ty Cổ phần Cung ứng và Dịch vụ Kỹ thuật Hàng Hải
MAFPF1	Quỹ đầu tư tăng trưởng Manulife
MAS	Công ty cổ phần Dịch vụ Hàng không Sân bay Đà Nẵng
MAX	Công ty Cổ phần Khai khoáng và Cơ khí Hữu nghị Vĩnh Sinh
MBB	Ngân hàng Thương mại Cổ phần Quân đội
MBG	Công ty cổ phần Tập đoàn MBG
MBN	Công ty cổ phần Môi trường và Công trình Đô thị Bắc Ninh
MBS	Công ty cổ phần Chứng khoán MB
MC3	Công ty Cổ phần Khoáng sản 3 - Vimico
MCC	Công ty Cổ phần Gạch ngói cao cấp
MCF	CTCP Xây lắp Cơ khí và Lương thực Thực phẩm
MCG	Công ty Cổ phần Cơ điện và Xây dựng Việt Nam
MCH	Công ty Cổ phần Hàng tiêu dùng Masan
MCI	CTCP Đầu tư Xây dựng và Phát triển Vật liệu IDICO
MCL	Công ty Cổ phần Phát triển Nhà và Sản xuất Vật liệu xây dựng Chí Linh
MCO	Công ty Cổ phần Đầu tư và Xây dựng BDC Việt Nam
MCP	Công ty cổ phần In và Bao bì Mỹ Châu
MCT	Công ty Cổ phần Kinh doanh Vật tư và Xây dựng
MCV	Công ty Cổ phần Cavico Việt Nam Khai thác Mỏ và Xây dựng
MDA	Công ty Cổ phần Môi trường Đô thị Đông Anh
MDC	Công ty cổ phần Than Mông Dương - Vinacomin
MDF	Công ty cổ phần Gỗ MDF VRG Quảng Trị
MDG	Công ty Cổ phần miền Đông
MDN	CTCP Tổng Công ty May Đồng Nai
MDT	CTCP Cơ khí mỏ và Đóng tàu - TKV
MEC	Công ty Cổ phần Cơ khí - lắp máy Sông Đà
MED	Công ty cổ phần Dược Trung ương Mediplantex
MEF	Công ty cổ phần MEINFA
MEG	Công ty cổ phần Megram
MEL	Công ty Cổ phần Thép Mê Lin
MES	Công ty cổ phần Cơ điện Công trình
MFS	Công ty Cổ phần Dịch vụ Kỹ thuật Mobifone
MGC	CTCP Địa chất mỏ - TKV
MGG	Tổng Công ty Đức Giang - Công ty Cổ phần
MH3	Công ty Cổ phần Khu công nghiệp Cao Su Bình Long
MHC	Công ty Cổ phần MHC
MHL	Công ty Cổ phần Minh Hữu Liên
MHY	Công ty TNHH MTV Môi trường và Công trình Đô thị Hưng Yên
MIC	Công ty Cổ phần Kỹ nghệ Khoáng sản Quảng Nam
MIE	Tổng Công ty Máy và Thiết bị Công nghiệp - CTCP
MIG	Tổng Công ty cổ phần Bảo hiểm Quân đội
MIH	Công ty Cổ phần Xuất nhập khẩu Khoáng sản Hà Nam
MIM	Công ty Cổ phần Khoáng sản và Cơ khí
MJC	Công ty Cổ phần Thương mại Mộc Hóa
MKP	Công ty Cổ phần Hóa - Dược phẩm Mekophar
MKT	Công ty cổ phần Dệt Minh Khai
MKV	Công ty Cổ phần Dược Thú y Cai Lậy
MLC	Công ty Cổ phần Môi trường Đô thị Tỉnh Lào Cai
MLN	Công ty cổ phần Mai Linh Miền Bắc
MLS	Công ty cổ phần Chăn nuôi - Mitraco
MMC	Công ty Cổ phần Khoáng sản Mangan
MML	Công ty Cổ phần Masan MEATLife
MNB	Tổng Công ty May Nhà Bè - Công ty Cổ phần
MNC	Công ty Cổ phần Tập đoàn Mai Linh Miền Trung
MND	Công ty Cổ phần Môi trường Nam Định
MPC	Công ty Cổ phần Tập đoàn Thủy sản Minh Phú
MPT	Công ty cổ phần Tập đoàn Trường Tiền
MPY	Công ty Cổ phần Môi trường Đô thị Phú Yên
MQB	Công ty Cổ phần Môi trường và phát triển Đô thị Quảng Bình
MQN	Công ty Cổ phần Môi trường đô thị Quảng Ngãi
MRF	Công ty cổ phần Merufa
MSC	Công ty cổ phần Dịch vụ Phú Nhuận
MSH	Công ty cổ phần May Sông Hồng
MSN	Công ty Cổ phần Tập đoàn MaSan
MSR	Công ty cổ phần Tài nguyên Masan
MST	Công ty Cổ phần Đầu tư MST
MTA	Tổng Công ty Khoáng sản và Thương mại Hà Tĩnh - CTCP
MTC	CTCP Dịch vụ Du lịch Mỹ Trà
MTG	Công ty Cổ phần MT Gas
MTH	Công ty Cổ phần Môi trường Đô thị Hà Đông
MTL	CTCP Dịch vụ Môi trường Đô thị Từ Liêm
MTM	CTCP Mỏ và Xuất nhập khẩu Khoáng sản Miền Trung
MTP	Công ty Cổ phần Dược Medipharco
MTS	Công ty cổ phần Vật tư - TKV
MTV	Công ty Cổ phần Dịch vụ Môi trường và Công trình Đô thị Vũng Tàu
MVB	Tổng công ty Công nghiệp mỏ Việt Bắc TKV - CTCP
MVC	Công ty Cổ phần Vật liệu và Xây dựng Bình Dương
MVN	Tổng Công ty Hàng hải Việt Nam - Công ty TNHH MTV
MVY	Công ty Cổ phần Môi trường và Dịch vụ Đô thị Vĩnh Yên
MWG	Công ty cổ phần Đầu tư Thế giới Di động
NAC	Công ty Cổ phần Tư vấn Xây dựng Tổng hợp
NAF	Công ty Cổ phần Nafoods Group
NAG	Công ty cổ phần Tập đoàn Nagakawa
NAP	Công ty cổ phần Cảng Nghệ Tĩnh
NAS	Công ty Cổ phần Dịch vụ Hàng không Sân bay Nội Bài
NAU	Công ty cổ phần Môi trường và Công trình đô thị Nghệ An
NAV	Công ty Cổ phần Nam Việt
NAW	Công ty Cổ phần Cấp nước Nghệ An
NBB	Công ty Cổ phần Đầu tư Năm Bảy Bảy
NBC	Công ty cổ phần Than Núi Béo – Vinacomin
NBE	Công ty Cổ phần Sách và Thiết bị Giáo dục Miền Bắc
NBP	Công ty Cổ phần Nhiệt điện Ninh Bình
NBR	CTCP Đường sắt Nghĩa Bình
NBS	Công ty Cổ phần Bến xe Nghệ An
NBT	CTCP Cấp thoát nước Bến Tre
NBW	Công ty Cổ phần Cấp nước Nhà Bè
NCP	Công ty Cổ phần Nhiệt điện Cẩm Phả - TKV
NCS	Công ty cổ phần Suất ăn Hàng không Nội Bài
NCT	Công ty Cổ phần Dịch vụ Hàng hóa Nội Bài
ND2	Công ty Cổ phần Đầu tư Phát triển điện Miền Bắc 2
NDC	Công ty Cổ phần Nam Dược
NDF	CTCP Chế biến thực phẩm nông sản xuất khẩu Nam Định
NDN	Công ty Cổ phần Đầu tư Phát triển Nhà Đà Nẵng
NDP	Công ty Cổ phần Dược phẩm 2/9
NDT	Tổng Công ty cổ phần Dệt may Nam Định
NDW	CTCP Cấp nước Nam Định
NDX	Công ty Cổ phần Xây lắp Phát triển Nhà Đà Nẵng
NED	Công ty cổ phần Đầu tư và Phát triển Điện Tây Bắc
NET	Công ty Cổ phần Bột giặt Net
NFC	Công ty Cổ phần Phân lân Ninh Bình
NGC	Công ty Cổ phần Chế biến Thủy sản Xuất khẩu Ngô Quyền
NHA	Tổng Công ty Đầu tư Phát triển Nhà và Đô thị Nam Hà Nội
NHC	Công ty Cổ phần Gạch Ngói Nhị Hiệp
NHH	Công ty Cổ phần Nhựa Hà Nội
NHN	Công ty cổ phần Phát triển đô thị Nam Hà Nội
NHP	Công ty Cổ phần Sản xuất Xuất nhập khẩu NHP
NHS	Công ty Cổ phần Đường Ninh Hòa
NHT	Công ty Cổ phần Sản xuất và Thương mại Nam Hoa
NHV	Công ty cổ phần Đầu tư NHV
NHW	Công ty Cổ phần Ngô Han
NIS	Công ty Cổ phần Dịch vụ Hạ tầng mạng
NKD	Công ty Cổ phần Chế biến Thực phẩm Kinh Đô Miền Bắc
NKG	Công ty Cổ phần Thép Nam Kim
NLC	Công ty Cổ phần Thủy điện Nà Lơi
NLG	Công ty cổ phần Đầu tư Nam Long
NLS	Công ty cổ phần Cấp thoát Nước Lạng Sơn
NMK	Công ty cổ phần Xây dựng Công trình 510
NNB	CTCP Cấp thoát nước Ninh Bình
NNC	Công ty Cổ phần Đá Núi Nhỏ
NNG	Công ty Cổ phần Công nghiệp - Dịch vụ - Thương Mại Ngọc Nghĩa
NNQ	Trung tâm Giống Nông - Lâm nghiệp Quảng Nam
NNT	Công ty cổ phần Cấp nước Ninh Thuận
NOS	Công ty Cổ phần Vận tải biển và Thương mại Phương Đông
NPH	CTCP Khách sạn Bưu điện Nha Trang
NPS	Công ty Cổ phần May Phú Thịnh - Nhà Bè
NQB	Công ty cổ phần Cấp nước Quảng Bình
NQN	Công ty Cổ phần Nước sạch Quảng Ninh
NQT	Công ty Cổ phần Nước sạch Quảng Trị
NRC	Công ty Cổ phần Bất động sản Netland
NS2	Công ty Cổ phần Nước sạch số 2 Hà Nội
NS3	CTCP Sản xuất Kinh doanh Nước sạch số 3 Hà Nội
NSC	Công ty cổ phần Tập đoàn Giống cây trồng Việt Nam
NSG	CTCP Nhựa Sài Gòn
NSH	Công ty Cổ phần Nhôm Sông Hồng
NSL	Công ty cổ phần Cấp nước Sơn La
NSN	Công ty Cổ phần Xây dựng 565
NSP	Công ty Cổ phần Nhựa Sam Phú
NSS	Công ty cổ phần Nông Súc Sản Đồng Nai
NST	Công ty Cổ phần Ngân Sơn
NT2	Công ty Cổ phần Điện lực Dầu khí Nhơn Trạch 2
NTB	Công ty cổ phần Đầu tư Xây dựng và Khai thác Công trình Giao thông 584
NTC	Công ty Cổ phần Khu Công nghiệp Nam Tân Uyên
NTF	CTCP Dược - Vật tư Y tế Nghệ An
NTH	Công ty Cổ phần thủy điện Nước Trong
NTL	Công ty Cổ phần Phát triển Đô thị Từ Liêm
NTP	Công ty Cổ phần Nhựa Thiếu niên Tiền Phong
NTR	Công ty Cổ Phần Đường sắt Nghệ Tĩnh
NTT	Công ty Cổ phần Dệt - May Nha Trang
NTW	Công ty cổ phần Cấp nước Nhơn Trạch
NUE	Công ty Cổ phần Môi trường Đô thị Nha Trang
NVB	Ngân hàng Thương mại cổ phần Quốc Dân
NVC	Công ty Cổ phần Nam Vang
NVL	Công ty cổ phần Tập đoàn Đầu tư Địa ốc No Va
NVN	Công ty Cổ phần Nhà Việt Nam
NVP	Công ty Cổ phần Nước sạch Vĩnh Phúc
NVT	Công ty Cổ phần Bất động sản Du lịch Ninh Vân Bay
NWT	CTCP Vận tải Newway
OCH	Công ty Cổ phần Khách sạn và Dịch vụ Đại Dương
OGC	Công ty Cổ phần Tập đoàn Đại Dương
OIL	Tổng Công ty Dầu Việt Nam - CTCP
OLC	Công ty cổ phần Xây dựng Dịch vụ và Hợp tác lao động
ONE	Công ty Cổ phần Truyền thông số 1
ONW	Công ty Cổ phần Dịch vụ Một Thế giới
OPC	Công ty cổ phần Dược phẩm OPC
ORS	Công ty Cổ phần Chứng khoán Tiên Phong
PAC	Công ty Cổ phần Pin Ắc quy Miền Nam
PAI	CTCP Công nghệ thông tin viễn thông và tự động hóa Dầu khí
PAN	Công ty Cổ phần Tập đoàn PAN
PBC	CTCP Dược phẩm Trung ương I - Pharbaco
PBK	Công ty cổ phần Điện lực Dầu khí Bắc Kạn
PBP	Công ty cổ phần Bao bì Dầu khí Việt Nam
PBT	Công ty cổ phần Nhà và Thương mại Dầu khí
PC1	Công ty cổ phần Xây lắp điện 1
PCC	Công ty Cổ phần Tập đoàn Xây lắp 1 - Petrolimex
PCE	Công ty cổ phần Phân bón và Hóa chất Dầu khí Miền Trung
PCF	Công ty cổ phần Cà Phê Petec
PCG	Công ty Cổ phần Đầu tư và Phát triển Gas Đô Thị
PCM	Công ty Cổ phần Vật liệu Xây dựng Bưu điện
PCN	Công ty cổ phần Hóa phẩm dầu khí DMC - miền Bắc
PCT	Công ty cổ phần Vận tải khí và hóa chất Việt Nam
PDB	Công ty Cổ phần Vật liệu xây dựng Dufago
PDC	Công ty cổ phần Du lịch Dầu khí Phương Đông
PDN	Công ty Cổ phần Cảng Đồng Nai
PDR	Công ty cổ phần Phát triển Bất động sản Phát Đạt
PDT	Công ty TNHH MTV Thương mại Dầu khí Đồng Tháp
PDV	Công ty cổ phần Vận tải dầu Phương Đông Việt
PEC	Công ty Cổ phần Cơ khí Điện lực
PEG	Tổng Công ty Thương mại Kỹ thuật và Đầu tư - CTCP
PEN	Công ty cổ phần Xây lắp III Petrolimex
PEQ	Công ty cổ phần Thiết bị Xăng dầu Petrolimex
PET	Tổng Công ty Cổ phần Dịch vụ Tổng hợp Dầu khí
PFL	Công ty cổ phần Dầu khí Đông Đô
PFV	Công ty Cổ phần Đầu tư và Thương mại PFV
PGC	Tổng Công ty Gas Petrolimex-CTCP
PGD	Công ty Cổ phần Phân phối Khí thấp áp Dầu khí Việt Nam
PGI	Tổng Công ty cổ phần Bảo hiểm Petrolimex
PGN	Công ty Cổ phần Phụ gia Nhựa
PGS	Công ty Cổ phần Kinh doanh Khí Miền Nam
PGT	Công ty Cổ phần PGT Holdings
PGV	Tổng Công ty Phát điện 3 - Công ty cổ phần
PHC	Công ty cổ phần Xây dựng Phục Hưng Holdings
PHH	Công ty Cổ phần Hồng Hà Việt Nam
PHN	Công ty Cổ phần Pin Hà Nội
PHP	Công ty cổ phần Cảng Hải Phòng
PHR	Công ty cổ phần Cao su Phước Hòa
PHS	Công ty Cổ phần Chứng khoán Phú Hưng
PHT	Công ty Cổ phần Sản xuất và Thương mại Phúc Tiến
PIA	Công ty cổ phần Tin học Viễn thông Petrolimex
PIC	Công ty cổ phần Đầu tư Điện lực 3
PID	Công ty Cổ phần Trang trí Nội thất Dầu khí
PIS	Tổng Công ty Pisico Bình Định - CTCP
PIT	Công ty Cổ phần Xuất nhập khẩu Petrolimex
PIV	Công ty Cổ phần PIV
PJC	Công ty Cổ phần Thương mại và Vận tải Petrolimex Hà Nội
PJS	Công ty cổ phần Cấp nước Phú Hòa Tân
PJT	Công ty Cổ phần Vận tải Xăng dầu Đường thủy Petrolimex
PKR	Công ty Cổ phần Đường sắt Phú Khánh
PLA	Công ty cổ phần Đầu tư Dịch vụ Hạ tầng Xăng Dầu
PLC	Tổng Công ty Hóa dầu Petrolimex-CTCP
PLO	Công ty Cổ phần Kho Vận Petec
PLP	Công ty Cổ phần Sản xuất và Công nghệ Nhựa Pha Lê
PLX	Tập đoàn Xăng dầu Việt Nam
PMB	Công ty cổ phần Phân bón và Hóa chất Dầu khí Miền Bắc
PMC	Công ty Cổ phần Dược phẩm Dược liệu Pharmedic
PME	Công ty Cổ phần Pymepharco
PMG	Công ty Cổ phần Đầu tư và Sản xuất Petro Miền Trung
PMJ	Công ty cổ phần Vật tư Bưu điện
PMP	Công ty cổ phần Bao bì Đạm Phú Mỹ
PMS	Công ty Cổ phần Cơ khí Xăng dầu
PMT	Công ty cổ phần Viễn thông TELVINA Việt Nam
PMW	Công ty cổ phần Cấp nước Phú Mỹ
PNC	Công ty Cổ phần Văn hóa Phương Nam
PND	Công ty Cổ phần Xăng dầu Dầu khí Nam Định
PNG	Công ty cổ phần Thương mại Phú Nhuận
PNJ	Công ty Cổ phần Vàng bạc Đá quý Phú Nhuận
PNP	Công ty cổ phần Tân Cảng - Phú Hữu
PNT	Công ty cổ phần Kỹ thuật Xây dựng Phú Nhuận
POB	Công ty Cổ phần Xăng dầu Dầu khí Thái Bình
POM	Công ty Cổ phần Thép Pomina
POS	Công ty Cổ phần Dịch vụ Lắp đặt Vận hành và Bảo dưỡng Công trình Dầu khí biển PTSC
POT	Công ty Cổ phần Thiết bị Bưu điện
POV	Công ty Cổ phần Xăng dầu Dầu khí Vũng Áng
POW	Tổng Công ty Điện lực Dầu khí Việt Nam
PPC	Công ty Cổ phần Nhiệt điện Phả Lại
PPE	Công ty cổ phần Tư vấn Điện lực Dầu khí Việt Nam
PPG	Công ty cổ phần Sản xuất Thương mại Dịch vụ Phú Phong
PPH	Tổng Công ty Cổ phần Phong Phú
PPI	Công ty Cổ phần Đầu tư và Phát triển Dự án Hạ tầng Thái Bình Dương
PPP	Công ty Cổ phần Dược phẩm Phong Phú
PPS	Công ty Cổ phần Dịch vụ Kỹ thuật Điện lực Dầu khí Việt Nam
PPY	CTCP Xăng dầu Dầu khí Phú Yên
PQN	CTCP Dịch vụ Dầu khí Quảng Ngãi PTSC
PRC	Công ty Cổ phần Logistics Portserco
PRO	Công ty Cổ phần Procimex Việt Nam
PRT	Tổng công ty Sản xuất - Xuất nhập khẩu Bình Dương - TNHH MTV
PRUBF1	Quỹ Đầu tư Cân bằng Prudential
PSB	Công ty cổ phần Đầu tư Dầu khí Sao Mai – Bến Đình
PSC	Công ty cổ phần Vận tải và Dịch vụ Petrolimex Sài Gòn
PSD	Công ty cổ phần Dịch vụ Phân phối Tổng hợp Dầu khí
PSE	Công ty cổ phần Phân bón và Hóa chất Dầu khí Đông Nam Bộ
PSG	Công ty Cổ phần Đầu tư và Xây lắp Dầu khí Sài Gòn
PSI	Công ty cổ phần Chứng khoán Dầu khí
PSL	Công ty Cổ phần Chăn nuôi Phú Sơn
PSN	Công ty Cổ phần Cảng dịch vụ Dầu khí Tổng hợp PTSC Thanh Hóa
PSP	Công ty Cổ phần Cảng dịch vụ Dầu khí Đình Vũ
PSW	Công ty cổ phần Phân bón và Hóa chất Dầu khí Tây Nam Bộ
PTB	Công ty Cổ phần Phú Tài
PTC	Công ty Cổ phần Đầu tư và Xây dựng Bưu điện
PTD	CTCP Thiết kế - Xây dựng - Thương mại Phúc Thịnh
PTE	Công ty Cổ phần Xi măng Phú Thọ
PTG	Công ty Cổ phần May Xuất khẩu Phan Thiết
PTH	Công ty Cổ phần Vận tải và Dịch vụ Petrolimex Hà Tây
PTI	Tổng Công ty Cổ phần Bảo hiểm Bưu điện
PTK	Công ty Cổ phần Luyện kim Phú Thịnh
PTL	Công ty Cổ phần Đầu tư Hạ tầng và Đô thị Dầu khí PVC
PTM	Công ty cổ phần Sản xuất Thương mại và Dịch vụ ôtô PTM
PTO	Công ty Cổ phần Dịch vụ - Xây dựng Công trình Bưu điện
PTP	Công ty Cổ phần Dịch vụ Viễn thông và In Bưu điện
PTS	Công ty Cổ phần Vận tải và Dịch vụ Petrolimex Hải Phòng
PTT	Công ty Cổ phần Vận tải Dầu khí Đông Dương
PTV	Công ty cổ phần Thương mại Dầu khí
PTX	Công ty cổ phần Vận tải và Dịch vụ Petrolimex Nghệ Tĩnh
PV2	Công ty cổ phần Đầu tư PV2
PVA	Công ty Cổ phần Tổng Công ty Xây lắp Dầu khí Nghệ An
PVB	Công ty cổ phần Bọc ống Dầu khí Việt Nam
PVC	Tổng Công ty Hóa chất và Dịch vụ Dầu khí - CTCP
PVD	Tổng Công ty Cổ phần Khoan và Dịch vụ Khoan Dầu khí
PVE	Tổng Công ty Tư vấn Thiết kế Dầu khí-CTCP
PVF	Tổng Công ty Tài chính Cổ phần Dầu khí Việt Nam
PVG	Công ty Cổ phần Kinh doanh LPG Việt Nam
PVH	Công ty cổ phần Xây lắp dầu khí Thanh Hóa
PVI	Công ty Cổ phần PVI
PVL	Công ty cổ phần Đầu tư Nhà đất Việt
PVM	Công ty Cổ phần Máy - Thiết bị Dầu khí
PVO	CTCP Dầu nhờn PV Oil
PVP	Công ty Cổ phần Vận tải dầu khí Thái Bình Dương
PVR	Công ty Cổ phần đầu tư PVR Hà Nội
PVS	Tổng Công ty Cổ phần Dịch vụ Kỹ thuật Dầu khí Việt Nam
PVT	Tổng công ty Cổ phần Vận tải Dầu khí
PVV	Công ty Cổ phần Vinaconex 39
PVX	Tổng Công ty cổ phần Xây lắp Dầu khí Việt Nam
PVY	Công ty Cổ phần Chế tạo Giàn khoan Dầu khí
PWA	Công ty Cổ phần Bất động sản Dầu khí
PWS	Công ty Cổ phần Cấp thoát nước Phú Yên
PX1	Công ty cổ phần Xi măng Sông Lam 2
PXA	Công ty cổ phần Đầu tư & Thương mại Dầu khí Nghệ An
PXC	Công ty cổ phần Phát triển đô thị Dầu khí
PXI	Công ty Cổ phần Xây dựng công nghiệp và dân dụng Dầu khí
PXL	Tổng Công ty cổ phần Đầu tư và Phát triển KCN Dầu khí-Long Sơn
PXM	Công ty Cổ phần Xây lắp Dầu khí Miền Trung
PXS	Công ty Cổ phần Kết cấu Kim loại và Lắp máy Dầu khí
PXT	Công ty Cổ phần Xây lắp Đường ống Bể chứa Dầu khí
PYU	Công ty Cổ phần Môi trường và Công trình Đô thị Phúc Yên
QBR	Công ty Cổ Phần Đường sắt Quảng Bình
QBS	Công ty Cổ phần Xuất nhập khẩu Quảng Bình
QCC	CTCP Đầu tư Xây dựng và Phát triển Hạ tầng Viễn thông
QCG	Công ty Cổ phần Quốc Cường Gia Lai
QHD	Công ty Cổ phần Que hàn điện Việt Đức
QHW	CTCP Nước khoáng Quảng Ninh
QLD	Công ty Cổ phần Quản lý và Xây dựng giao thông Lạng Sơn
QLT	Công ty Cổ phần Quản lý Bảo trì Đường thủy nội địa số 10
QNC	Công ty Cổ phần Xi măng và Xây dựng Quảng Ninh
QNS	Công ty Cổ phần Đường Quảng Ngãi
QNT	Trung tâm Tư vấn xây dựng thị xã Điện Bàn
QNU	Công ty Cổ phần Môi trường Đô thị Quảng Nam
QNW	CTCP Cấp thoát nước và Xây dựng Quảng Ngãi
QPH	Công ty Cổ phần Thủy điện Quế Phong
QSP	Công ty cổ phần Tân Cảng Quy Nhơn
QST	Công ty Cổ phần Sách và Thiết bị trường học Quảng Ninh
QTC	Công ty Cổ phần Công trình Giao thông Vận tải Quảng Nam
QTP	Công ty Cổ phần Nhiệt điện Quảng Ninh
RAL	Công ty Cổ phần Bóng đèn Phích nước Rạng Đông
RAT	CTCP Vận tải và Thương mại Đường sắt
RBC	CTCP Công nghiệp và Xuất nhập khẩu Cao Su
RCC	Công ty Cổ phần Tổng công ty Công trình đường sắt
RCD	Công ty cổ phần Xây dựng - Địa ốc Cao su
RCL	Công ty Cổ phần Địa ốc Chợ Lớn
RDP	Công ty Cổ phần Rạng Đông Holding
REE	Công ty Cổ phần Cơ điện lạnh
REM	Công ty cổ phần Tu bổ di tích Trung ương - Vinaremon
RGC	Công ty cổ phần Đầu tư PV - Inconess
RHC	Công ty Cổ phần Thủy điện Ry Ninh II
RHN	Công ty Cổ phần Đường sắt Hà Ninh
RIC	Công ty Cổ phần Quốc tế Hoàng Gia
RLC	Công ty Cổ phần Đường bộ Lào Cai
ROS	Công ty cổ phần Xây dựng FLC Faros
RTB	Công ty cổ phần Cao su Tân Biên
RTH	Công ty Cổ phần Đường sắt Thanh Hóa
RTS	CTCP Thông tin tín hiệu Đường sắt Đà Nẵng
S12	Công ty Cổ phần Sông Đà 12
S27	Công ty cổ phần Sông Đà 27
S33	Công ty cổ phần Mía đường 333
S4A	Công ty Cổ phần Thủy điện Sê San 4A
S55	Công ty Cổ phần Sông Đà 505
S64	Công ty Cổ phần Sông Đà 6.04
S72	Công ty Cổ phần Sông Đà 7.02
S74	Công ty Cổ phần Sông Đà 7.04
S91	Công ty Cổ phần Sông Đà 9.01
S96	Công ty Cổ phần Sông Đà 9.06
S99	Công ty Cổ phần SCI
SAB	Tổng CTCP Bia - Rượu - Nước giải khát Sài Gòn
SAC	Công ty Cổ phần Xếp dỡ và Dịch vụ Cảng Sài Gòn
SAF	Công ty Cổ phần Lương thực Thực phẩm Safoco
SAL	Công ty Cổ phần Trục vớt cứu hộ Việt Nam
SAM	Công ty Cổ phần SAM Holdings
SAP	Công ty Cổ phần In Sách giáo khoa tại Tp.Hồ Chí Minh
SAS	CTCP Dịch vụ Hàng không Sân bay Tân Sơn Nhất
SAV	Công ty Cổ phần Hợp tác kinh tế và Xuất nhập khẩu SAVIMEX
SB1	Công ty cổ phần Bia Sài Gòn - Nghệ Tĩnh
SBA	Công ty Cổ phần Sông Ba
SBC	Công ty Cổ phần Vận tải và Giao nhận bia Sài Gòn
SBD	Công ty Cổ phần Công nghệ Sao Bắc Đẩu
SBH	Công ty cổ phần Thủy điện Sông Ba Hạ
SBL	Công ty Cổ phần Bia Sài Gòn - Bạc Liêu
SBM	Công ty Cổ phần Đầu tư Phát triển Bắc Minh
SBS	Công ty Cổ phần Chứng khoán Ngân hàng Sài Gòn Thương Tín
SBT	Công ty cổ phần Thành Thành Công - Biên Hòa
SBV	CTCP Siam Brothers Việt Nam
SC5	Công ty Cổ phần Xây dựng số 5
SCC	Công ty Cổ phần Đầu tư Thương mại Hưng Long tỉnh Hòa Bình
SCD	Công ty Cổ phần Nước giải khát Chương Dương
SCH	CTCP Thủy điện Sông chảy 5
SCI	Công ty Cổ phần SCI E&C
SCJ	Công ty Cổ phần Xi măng Sài Sơn
SCL	Công ty Cổ phần Sông Đà Cao Cường
SCO	Công ty Cổ phần Công nghiệp Thủy sản
SCR	Công ty Cổ phần Địa ốc Sài Gòn Thương Tín
SCS	Công ty cổ phần Dịch vụ Hàng hóa Sài Gòn
SCY	Công ty Cổ phần Đóng tàu Sông Cấm
SD1	Công ty Cổ phần Sông Đà 1
SD2	Công ty Cổ phần Sông Đà 2
SD3	Công ty Cổ phần Sông Đà 3
SD4	Công ty Cổ phần Sông Đà 4
SD5	Công ty Cổ phần Sông Đà 5
SD6	Công ty Cổ phần Sông Đà 6
SD7	Công ty Cổ phần Sông Đà 7
SD8	Công ty Cổ phần Sông Đà 8
SD9	Công ty Cổ phần Sông Đà 9
SDA	Công ty Cổ phần Simco Sông Đà
SDB	Công ty Cổ phần Sông Đà 207
SDC	Công ty Cổ phần Tư vấn Sông Đà
SDD	Công ty Cổ phần Đầu tư và Xây lắp Sông Đà
SDE	Công ty cổ phần Kỹ thuật Điện Sông Đà
SDF	Công ty Tài chính cổ phần Sông Đà
SDG	Công ty Cổ phần Sadico Cần Thơ
SDH	Công ty Cổ phần Xây dựng hạ tầng Sông Đà
SDI	Công ty cổ phần Đầu tư và Phát triển Đô thị Sài Đồng
SDJ	Công ty Cổ phần Sông Đà 25
SDK	Công ty Cổ phần Cơ khí Luyện kim
SDN	Công ty Cổ phần Sơn Đồng Nai
SDP	Công ty cổ phần SDP
SDS	Công ty Cổ phần Xây lắp và Đầu tư Sông Đà
SDT	Công ty Cổ phần Sông Đà 10
SDU	Công ty Cổ phần Đầu tư Xây dựng và Phát triển Đô thị Sông Đà
SDV	Công ty Cổ phần Dịch vụ Sonadezi
SDX	CTCP Phòng cháy chữa cháy và Đầu tư Xây dựng Sông Đà
SDY	Công ty Cổ phần Xi măng Sông Đà Yaly
SEA	Tổng công ty Thủy sản Việt Nam – CTCP
SEB	Công ty Cổ phần Đầu tư và Phát triển Điện miền Trung
SEC	Công ty Cổ phần Mía đường Nhiệt điện Gia Lai
SED	Công ty Cổ phần Đầu tư và Phát triển giáo dục Phương Nam
SEL	Công ty Cổ phần Sông Đà 11 Thăng Long
SEP	Công ty Cổ phần Tổng Công ty Thương mại Quảng Trị
SFC	Công ty Cổ phần Nhiên liệu Sài Gòn
SFG	Công ty Cổ phần Phân bón Miền Nam
SFI	Công ty Cổ phần Đại lý Vận tải SAFI
SFN	Công ty Cổ phần Dệt lưới Sài Gòn
SFT	CÔNG TY CỔ PHẦN SOFTECH
SGC	Công ty Cổ phần Xuất nhập khẩu Sa Giang
SGD	Công ty cổ phần Sách Giáo dục tại T.P Hồ Chí Minh
SGH	Công ty Cổ phần Khách sạn Sài Gòn
SGN	Công ty cổ phần Phục vụ Mặt đất Sài Gòn
SGO	Công ty cổ phần Dầu thực vật Sài Gòn
SGP	Công ty Cổ phần Cảng Sài Gòn
SGR	Công ty cổ phần Địa ốc Sài Gòn
SGS	Công ty Cổ phần Vận tải biển Sài Gòn
SGT	Công ty Cổ phần Công nghệ Viễn thông Sài Gòn
SHA	Công ty Cổ phần Sơn Hà Sài Gòn
SHB	Ngân hàng Thương mại cổ phần Sài Gòn - Hà Nội
SHC	Công ty Cổ phần Hàng Hải Sài Gòn
SHE	Công ty Cổ phần Phát triển năng lượng Sơn Hà
SHG	Tổng Công ty Cổ phần Sông Hồng
SHI	Công ty cổ phần Quốc tế Sơn Hà
SHN	Công ty Cổ phần Đầu tư Tổng hợp Hà Nội
SHP	Công ty cổ phần Thủy điện Miền Nam
SHS	Công ty Cổ phần Chứng Khoán Sài Gòn Hà Nội
SHV	Công ty Cổ phần Hải Việt
SHX	CTCP Sài Gòn Hỏa xa
SIC	Công ty cổ phần ANI
SID	Công ty Cổ phần Đầu tư Phát triển Sài Gòn Co.op
SIG	CTCP Đầu tư và Thương mại Sông Đà
SII	Công ty cổ phần Hạ tầng nước Sài Gòn
SIP	CTCP Đầu tư Sài Gòn VRG
SIV	Công ty Cổ phần SIVICO
SJ1	Công ty cổ phần Nông nghiệp Hùng Hậu
SJC	Công ty Cổ phần Sông Đà 1.01
SJD	Công ty Cổ phần Thủy điện Cần Đơn
SJE	Công ty Cổ phần Sông Đà 11
SJF	CTCP Đầu tư Sao Thái Dương
SJG	Tổng Công ty Sông Đà - Công ty cổ phần
SJM	Công ty Cổ phần Sông Đà 19
SJS	Công ty Cổ phần Đầu tư Phát triển Đô thị và Khu Công nghiệp Sông Đà
SKG	Công ty Cổ phần Tàu cao tốc Superdong – Kiên Giang
SKH	CTCP Nước giải khát Sanest Khánh Hòa
SKN	CTCP Nước giải khát Sanna Khánh Hòa
SKS	Công ty cổ phần Công trình Giao thông Sông Đà
SKV	Công ty Cổ phần Nước giải khát Yến sào Khánh Hòa
SLC	CTCP Dịch vụ xuất khẩu lao động và chuyên gia
SLS	Công ty cổ phần Mía đường Sơn La
SMA	Công ty Cổ phần Thiết bị Phụ tùng Sài Gòn
SMB	Công ty Cổ phần Bia Sài Gòn - Miền Trung
SMC	Công ty Cổ phần Ðầu tư Thương mại SMC
SME	Công ty Cổ phần Chứng khoán SME
SMN	Công ty Cổ phần Sách và Thiết bị Giáo dục Miền Nam
SMT	Công ty cổ phần SAMETEL
SNC	Công ty Cổ phần Xuất nhập khẩu Thuỷ sản Năm Căn
SNG	Công ty TNHH MTV Sông Đà 10.1
SNZ	Tổng Công ty Cổ phần phát triển khu Công nghiệp
SON	Công ty Cổ phần Cung ứng nhân lực Quốc tế và Thương mại
SOV	Công ty cổ phần Mắt kính Sài Gòn
SP2	CTCP Thủy điện Sử Pán 2
SPA	Công ty Cổ Phần Bao bì Sài Gòn
SPB	Công ty cổ phần Sợi Phú Bài
SPC	Công ty Cổ phần Bảo vệ Thực vật Sài Gòn
SPD	Công ty Cổ phần Xuất nhập khẩu Thủy sản Miền Trung
SPH	Công ty cổ phần Xuất nhập khẩu Thủy sản Hà Nội
SPI	Công ty cổ phần SPI
SPM	Công ty Cổ phần S.P.M
SPP	Công ty cổ phần Bao bì Nhựa Sài Gòn
SPV	Công ty cổ phần Thủy Đặc Sản
SQC	Công ty Cổ phần Khoáng sản Sài Gòn - Quy Nhơn
SRA	Công ty Cổ phần Sara Việt Nam
SRB	Công ty Cổ phần Tập đoàn Sara
SRC	Công ty Cổ phần Cao Su Sao Vàng
SRF	Công ty Cổ phần Kỹ Nghệ Lạnh
SRT	Công ty Cổ phần Vận tải Đường sắt Sài Gòn
SSC	Công ty Cổ phần Giống cây trồng Miền Nam
SSF	Công ty Cổ phần Giầy Sài Gòn
SSG	Công ty Cổ phần Vận tải biển Hải Âu
SSI	Công ty cổ phần Chứng khoán SSI
SSM	Công ty Cổ phần Chế tạo Kết cấu Thép VNECO.SSM
SSN	Công ty Cổ phần Xuất nhập khẩu Thủy sản Sài Gòn
SSS	Công ty Cổ phần Sông Đà 6.06
SST	CTCP Thương mại Bia Sài Gòn Sông Tiền
SSU	CTCP Môi trường Đô thị Sóc Sơn
ST8	Công ty Cổ phần Siêu Thanh
STB	Ngân hàng Thương mại Cổ phần Sài Gòn Thương Tín
STC	Công ty Cổ phần Sách và Thiết bị trường học Tp. Hồ Chí Minh
STD	CTCP Bia - Nước giải khát Sài Gòn - Tây Đô
STG	Công ty Cổ phần Kho vận Miền Nam
STH	CTCP Phát hành sách Thái Nguyên
STK	Công ty cổ phần Sợi Thế Kỷ
STL	Công ty cổ phần Sông Đà - Thăng Long
STP	Công ty Cổ phần Công nghiệp Thương mại Sông Đà
STS	Công ty Cổ phần Dịch vụ Vận tải Sài Gòn
STT	Công ty cổ phần Vận chuyển Sài Gòn Tourist
STU	Công ty Cổ phần Môi trường và Công trình Đô thị Sơn Tây
STV	Công ty cổ phần Chế tác Đá Việt Nam
STW	Công ty cổ phần Cấp nước Sóc Trăng
SUM	Công ty Cổ phần Đo đạc và Khoáng sản
SVC	Công ty Cổ phần Dịch vụ tổng hợp Sài Gòn
SVG	CTCP Hơi Kỹ nghệ Que hàn
SVH	Công ty Cổ phần Thủy điện Sông Vàng
SVI	Công ty Cổ phần Bao bì Biên Hòa
SVL	Công ty Cổ phần Nhân lực Quốc tế Sovilaco
SVN	Công ty cổ phần Tập đoàn Vexilla Việt Nam
SVS	Công ty Cổ phần Chứng khoán Sao Việt
SVT	Công ty Cổ phần Công nghệ Sài Gòn Viễn Đông
SWC	Tổng Công ty Cổ phần Đường Sông Miền Nam
SZB	Công ty cổ phần Sonadezi Long Bình
SZC	Công ty cổ phần Sonadezi Châu Đức
SZE	Công ty Cổ phần Môi trường Sonadezi
SZL	Công ty cổ phần Sonadezi Long Thành
T12	Công ty Cổ phần Thương mại dịch vụ Tràng Thi
TA3	Công ty Cổ phần Đầu tư và Xây lắp Thành An 386
TA6	Công ty Cổ phần Đầu tư và Xây lắp Thành An 665
TA9	Công ty Cổ phần Xây lắp Thành An 96
TAC	Công ty Cổ phần Dầu Thực vật Tường An
TAG	Công ty Cổ phần Thế giới số Trần Anh
TAN	Công ty TNHH Một thành viên Cà phê Thuận An
TAP	Công ty cổ phần Đô thị Tân An
TAR	Công ty Cổ phần Nông nghiệp Công nghệ cao Trung An
TAS	Công ty Cổ phần Chứng khoán Tràng An
TAW	CTCP Cấp nước Trung An
TB8	CTCP Sản xuất và Kinh doanh Vật tư Thiết bị - VVMI
TBC	Công ty cổ phần Thủy điện Thác Bà
TBD	Tổng Công ty Thiết bị Điện Đông Anh - Công ty Cổ phần
TBN	Công ty Cổ phần Thoát nước và Xử lý Nước thải Bắc Ninh
TBR	Công ty Cổ phần Địa ốc Tân Bình
TBT	Công ty Cổ phần Xây dựng Công trình Giao thông Bến Tre
TBX	Công ty Cổ phần Xi măng Thái Bình
TC6	Công ty cổ phần Than Cọc Sáu - Vinacomin
TCB	Ngân hàng TMCP Kỹ Thương Việt Nam (Techcombank)
TCD	Công ty Cổ phần Đầu tư Phát triển Công nghiệp và Vận tải
TCH	Công ty cổ phần Đầu tư Dịch vụ Tài chính Hoàng Huy
TCI	Công ty cổ phần Chứng khoán Thành Công
TCJ	Công ty cổ phần Tô Châu
TCK	Tổng công ty cơ khí xây dựng - CTCP
TCL	Công ty Cổ phần Đại lý Giao nhận Vận tải Xếp dỡ Tân Cảng
TCM	Công ty Cổ phần Dệt may - Đầu tư - Thương mại Thành Công
TCO	Công ty Cổ phần Vận tải Đa phương thức Duyên Hải
TCR	Công ty Cổ phần Công nghiệp Gốm sứ Taicera
TCS	Công ty Cổ phần Than Cao Sơn - TKV
TCT	Công ty Cổ phần Cáp treo Núi Bà Tây Ninh
TCW	Công ty cổ phần Kho vận Tân Cảng
TDA	Công ty Cổ phần Đầu tư Xây lắp và Vật liệu Xây dựng Đông Anh
TDB	Công ty Cổ phần Thủy điện Định Bình
TDC	Công ty Cổ phần Kinh doanh và Phát triển Bình Dương
TDG	Công ty Cổ phần Dầu khí Thái Dương
TDH	Công ty Cổ phần Phát triển Nhà Thủ Đức
TDM	Công ty cổ phần Nước Thủ Dầu Một
TDN	Công ty Cổ phần Than Đèo Nai - Vinacomin
TDP	Công ty cổ phần Thuận Đức
TDS	Công ty cổ phần Thép Thủ Đức - Vnsteel
TDT	Công ty cổ phần Đầu tư và Phát triển TDT
TDW	Công ty Cổ phần Cấp nước Thủ Đức
TEC	Công ty Cổ phần Traenco
TEG	Công ty cổ phần Bất động sản và Xây dựng Trường Thành
TEL	Công ty Cổ phần Phát triển Công trình Viễn thông
TET	Công ty Cổ phần Vải sợi May mặc Miền Bắc
TFC	Công ty Cổ phần Trang
TGG	Công ty Cổ phần Xây dựng và Đầu tư Trường Giang
TGP	Công ty Cổ phần Trường Phú
TH1	Công ty Cổ phần Xuất nhập khẩu Tổng hợp I Việt Nam
THB	Công ty cổ phần Bia Hà Nội - Thanh Hóa
THG	Công ty Cổ phần Đầu tư và Xây dựng Tiền Giang
THI	Công ty Cổ phần Thiết Bị Điện
THN	Công ty Cổ phần Cấp nước Thanh Hóa
THP	CTCP Thủy sản và Thương mại Thuận Phước
THR	Công ty Cổ phần Đường sắt Thuận Hải
THS	Công ty cổ phần Thanh Hoa - Sông Đà
THT	Công ty cổ phần Than Hà Tu - Vinacomin
THU	Công ty Cổ phần Môi trường và Công trình Đô thị Thanh Hóa
THV	Công ty Cổ phần Tập đoàn Thái Hòa Việt Nam
THW	Công ty cổ phần Cấp nước Tân Hòa
TIC	Công ty Cổ phần Đầu tư Điện Tây Nguyên
TID	Công ty cổ phần Tổng công ty Tín Nghĩa
TIE	Công ty Cổ phần TIE
TIG	Công ty Cổ phần Tập đoàn Đầu tư Thăng Long
TIP	Công ty cổ phần Phát triển Khu Công nghiệp Tín Nghĩa
TIS	Công ty cổ phần Gang thép Thái Nguyên
TIX	CTCP Sản xuất Kinh doanh Xuất nhập khẩu Dịch vụ và Đầu tư Tân Bình
TJC	Công ty cổ phần Dịch vụ Vận tải và Thương mại
TKC	Công ty Cổ phần Xây dựng và Kinh doanh Địa ốc Tân Kỷ
TKU	Công ty Cổ phần Công nghiệp Tung Kuang
TL4	Tổng công ty Xây dựng Thủy lợi 4 - CTCP
TLC	Công ty Cổ phần Viễn thông Thăng Long
TLD	Công ty Cổ phần Đầu tư Xây dựng và Phát triển Đô thị Thăng Long
TLG	Công ty Cổ phần Tập đoàn Thiên Long
TLH	Công ty Cổ phần Tập đoàn Thép Tiến Lên
TLI	Công ty cổ phần May Quốc tế Thắng Lợi
TLP	Tổng Công ty Thương mại Xuất nhập khẩu Thanh Lễ - TNHH MTV
TLT	Công ty Cổ phần Viglacera Thăng Long
TMB	Công ty Cổ phần Kinh doanh than Miền Bắc - Vinacomin
TMC	Công ty Cổ phần Thương mại - Xuất nhập khẩu Thủ Đức
TMG	Công ty Cổ phần Kim loại màu Thái Nguyên - Vimico
TMP	Công ty cổ phần Thủy điện Thác Mơ
TMS	Công ty Cổ phần Transimex
TMT	Công ty Cổ phần Ô tô TMT
TMW	Công ty Cổ phần Tổng hợp Gỗ Tân Mai
TMX	Công ty cổ phần VICEM Thương mại Xi măng
TN1	Công ty Cổ phần Thương mại Dịch vụ TNS Holdings
TNA	Công ty Cổ phần Thương mại Xuất nhập khẩu Thiên Nam
TNB	Công ty Cổ phần Thép Nhà Bè - VNSTEEL
TNC	Công ty Cổ phần Cao su Thống Nhất
TND	CTCP Than Tây Nam Đá Mài - Vinacomin
TNG	Công ty Cổ phần Đầu tư và Thương mại TNG
TNI	Công ty cổ phần Tập đoàn Thành Nam
TNM	Công ty Cổ phần Xuất nhập khẩu và Xây dựng Công trình
TNP	Công ty cổ phần Cảng Thị Nại
TNS	Công ty Cổ phần Thép Tấm lá Thống Nhất
TNT	Công ty Cổ phần Tài nguyên
TNW	Công ty Cổ phần Nước sạch Thái Nguyên
TNY	Công ty Cổ phần Đầu tư Xây dựng Thanh niên
TOP	CTCP Phân phối Top One
TOT	Công ty Cổ phần Vận tải Transimex
TOW	Công ty cổ phần Cấp nước Trà Nóc - Ô Môn
TPB	Ngân hàng Thương mại cổ phần Tiên Phong
TPC	Công ty Cổ phần Nhựa Tân Đại Hưng
TPH	Công ty Cổ phần In Sách giáo khoa tại T.P Hà Nội
TPP	Công ty Cổ phần Nhựa Tân Phú
TPS	CTCP Bến bãi Vận tải Sài Gòn
TQN	Công ty Cổ phần Thông Quảng Ninh
TQW	CTCP Cấp thoát nước Tuyên Quang
TRA	Công ty Cổ phần TRAPHACO
TRC	Công ty Cổ phần Cao su Tây Ninh
TRI	Công ty Cổ phần Nước giải khát Sài Gòn
TRS	CTCP Vận tải và Dịch vụ Hàng hải
TRT	Công ty Cổ phần Trúc Thôn
TS3	Công ty cổ phần Trường Sơn 532
TS4	Công ty cổ phần Thủy sản số 4
TS5	Công ty TNHH MTV 145
TSB	Công ty Cổ phần Ắc quy Tia sáng
TSC	Công ty Cổ phần Vật tư kỹ thuật Nông nghiệp Cần Thơ
TSD	Công ty Cổ phần Du lịch Trường Sơn COECCO
TSG	Công ty Cổ phần Thông tin Tín hiệu Đường sắt Sài Gòn
TSJ	Công ty Cổ phần Du lịch Dịch vụ Hà Nội
TSM	Công ty Cổ phần Xi măng Tiên Sơn Hà Tây
TST	Công ty Cổ phần Dịch vụ Kỹ thuật Viễn thông
TTB	Công ty cổ phần Tập đoàn Tiến Bộ
TTC	Công ty Cổ phần Gạch men Thanh Thanh
TTD	Công ty Cổ phần Bệnh viện Tim Tâm Đức
TTE	Công ty Cổ phần Đầu tư Năng lượng Trường Thịnh
TTF	Công ty Cổ phần Tập đoàn Kỹ nghệ Gỗ Trường Thành
TTG	Công ty Cổ phần May Thanh Trì
TTH	Công ty cổ phần Thương mại và Dịch vụ Tiến Thành
TTJ	Công ty Cổ phần Thủy Tạ
TTL	Tổng Công ty Thăng Long - CTCP
TTN	Công ty Cổ phần Công nghệ và Truyền thông Việt Nam
TTP	Công ty Cổ phần Bao bì Nhựa Tân Tiến
TTR	Công ty Cổ phần Du lịch Thương mại và Đầu tư
TTS	Công ty Cổ phần Cán thép Thái Trung
TTT	Công ty Cổ phần Du lịch – Thương mại Tây Ninh
TTV	CTCP Thông tin Tín hiệu Đường sắt Vinh
TTZ	Công ty cổ phần Đầu tư Xây dựng và Công nghệ Tiến Trung
TUG	Công ty Cổ phần Lai dắt và Vận tải Cảng Hải Phòng
TV1	Công ty cổ phần Tư vấn Xây dựng Điện 1
TV2	Công ty Cổ phần Tư vấn Xây dựng Điện 2
TV3	Công ty Cổ phần Tư vấn Xây dựng Điện 3
TV4	Công ty Cổ phần Tư vấn Xây dựng Điện 4
TVA	Công ty Cổ phần Sứ Viglacera Thanh Trì
TVB	Công ty cổ phần Chứng khoán Trí Việt
TVC	Công ty cổ phần Tập đoàn Quản lý Tài sản Trí Việt
TVD	Công ty cổ phần Than Vàng Danh - Vinacomin
TVG	Công ty cổ phần Tư vấn Đầu tư và Xây dựng Giao thông Vận tải
TVH	Công ty cổ phần Tư vấn và Xây dựng công trình Hàng Hải
TVM	CTCP Tư vấn Đầu tư Mỏ và Công nghiệp - Vinacomin
TVN	Tổng Công ty Thép Việt Nam - CTCP
TVP	Công ty Cổ phần Dược phẩm TV.Pharm
TVS	Công ty Cổ phần Chứng khoán Thiên Việt
TVT	Tổng Công ty Việt Thắng - CTCP
TVU	Công ty cổ phần Công trình Đô thị Trà Vinh
TVW	Công ty Cổ phần Cấp thoát nước Trà Vinh
TW3	CTCP Dược Trung ương 3
TXM	Công ty cổ phần VICEM Thạch cao Xi măng
TYA	Công ty Cổ phần Dây và Cáp điện Taya Việt Nam
UCT	Công ty Cổ phần Đô thị Cần Thơ
UDC	Công ty cổ phần Xây dựng và Phát triển Đô thị tỉnh Bà Rịa-Vũng Tàu
UDJ	Công ty Cổ phần Phát triển Đô thị
UDL	CTCP Đô thị và Môi trường Đắk Lắk
UEM	CTCP Cơ điện Uông Bí- Vinacomin
UIC	Công ty Cổ phần Đầu tư Phát triển Nhà và Đô thị Idico
UMC	Công ty cổ phần Công trình đô thị Nam Định
UNI	Công ty Cổ phần Viễn Liên
UPC	Công ty Cổ phần Phát triển Công viên cây xanh và Đô thị Vũng Tàu
UPH	CTCP Dược phẩm TW25
USC	Công ty Cổ phần Khảo sát và Xây dựng - USCO
USD	Công ty cổ phần Công trình Đô thị Sóc Trăng
V11	Công ty Cổ phần Xây dựng số 11
V12	Công ty Cổ phần Xây dựng số 12
V15	Công ty Cổ phần Xây dựng Số 15
V21	Công ty Cổ phần VINACONEX 21
VAF	Công ty cổ phần Phân lân nung chảy Văn Điển
VAT	Công ty Cổ phần VT Vạn Xuân
VAV	Công ty Cổ phần VIWACO
VBB	Ngân hàng Thương mại cổ phần Việt Nam Thương Tín
VBC	Công ty Cổ phần Nhựa Bao bì Vinh
VBG	Công ty Cổ phần Địa chất Việt Bắc - TKV
VBH	Công ty Cổ phần Điện tử Bình Hòa
VC1	Công ty Cổ phần Xây dựng số 1
VC2	Công ty Cổ phần Đầu tư và Xây dựng Vina2
VC3	Công ty Cổ phần Xây dựng số 3
VC5	Công ty Cổ phần Xây dựng số 5
VC6	Công ty Cổ phần Xây dựng và Đầu tư Visicons
VC7	Công ty Cổ phần Xây dựng số 7
VC9	Công ty Cổ phần Xây dựng số 9
VCA	Công ty Cổ phần Thép VICASA - VNSTEEL
VCB	Ngân hàng Thương mại cổ phần Ngoại thương Việt Nam
VCC	Công ty Cổ phần Vinaconex 25
VCE	CTCP Xây lắp Môi trường - TKV
VCF	Công ty Cổ phần VinaCafé Biên Hòa
VCG	Tổng Công ty Cổ phần Xuất nhập khẩu và Xây dựng Việt Nam
VCGPVF	Forum One - VCG Partners Vietnam Fund
VCH	Công ty Cổ phần Đầu tư và Phát triển Hạ tầng Vinaconex
VCI	Công ty cổ phần Chứng khoán Bản Việt
VCM	Công ty Cổ phần Nhân lực và Thương mại Vinaconex
VCP	Công ty cổ phần Đầu tư xây dựng và phát triển năng lượng Vinaconex
VCR	Công ty Cổ phần Đầu tư và Phát triển Du lịch Vinaconex
VCS	Công ty cổ phần VICOSTONE
VCT	Công ty Cổ phần Tư vấn Xây dựng Vinaconex
VCV	Công ty Cổ phần Vận tải Vinaconex
VCW	Công ty Cổ phần Đầu tư Nước sạch Sông Đà
VCX	Công ty Cổ phần Xi măng Yên Bình
VDB	Công ty cổ phần Vận tải và Chế biến Than Đông Bắc
VDL	Công ty Cổ phần Thực phẩm Lâm Đồng
VDM	CTCP - Viện nghiên cứu Dệt may
VDN	Công ty Cổ phần Vinatex Đà Nẵng
VDP	Công ty Cổ phần Dược phẩm Trung ương VIDIPHA
VDS	Công ty Cổ phần Chứng khoán Rồng Việt
VDT	Công ty cổ phần Lưới thép Bình Tây
VE1	Công ty Cổ phần Xây dựng điện VNECO 1
VE2	Công ty cổ phần Xây dựng điện VNECO 2
VE3	Công ty cổ phần Xây dựng điện VNECO 3
VE4	Công ty Cổ phần Xây dựng điện VNECO4
VE8	Công ty cổ phần Xây dựng điện VNECO 8
VE9	Công ty Cổ phần Đầu tư và Xây dựng VNECO 9
VEA	Tổng Công ty Máy động lực và máy nông nghiệp Việt Nam - CTCP
VEC	Tổng Công ty cổ phần Điện tử và Tin học Việt Nam
VECX	Tổng Công ty Đầu tư phát triển đường cao tốc Việt Nam
VEE	Công ty Cổ phần Thiết bị điện Cẩm Phả
VEF	CTCP Trung tâm Hội chợ Triển lãm Việt Nam
VES	Công ty Cổ phần Đầu tư và Xây dựng điện Mê Ca Vneco
VET	Công ty Cổ phần Thuốc thú y Trung ương Navetco
VFC	Công ty Cổ phần VINAFCO
VFG	Công ty Cổ phần Khử trùng Việt Nam
VFMVF1	Quỹ Đầu tư Chứng khoán Việt Nam
VFMVF4	Quỹ đầu tư Doanh nghiệp Hàng đầu Việt Nam
VFMVFA	Quỹ Đầu tư Năng động Việt Nam
VFMVN30	Quỹ ETF VFMVN30
VFR	Công ty Cổ phần Vận tải và Thuê tàu
VGC	Tổng Công ty Viglacera - CTCP
VGG	Tổng Công ty cổ phần May Việt Tiến
VGI	Tổng Công ty cổ phần Đầu tư Quốc tế Viettel
VGL	CTCP Mạ kẽm công nghiệp Vingal - Vnsteel
VGP	Công ty Cổ phần Cảng Rau quả
VGR	Công ty Cổ phần Cảng Xanh VIP
VGS	Công ty Cổ phần Ống thép Việt Đức VG PIPE
VGT	Tập đoàn Dệt may Việt Nam
VGV	Tổng Công ty Tư vấn Xây dựng Việt Nam - CTCP
VHC	Công ty Cổ phần Vĩnh Hoàn
VHD	Công ty Cổ phần Đầu tư phát triển Nhà và Đô thị Vinaconex
VHE	Công ty Cổ phần Dược liệu và Thực phẩm Việt Nam
VHF	Công ty Cổ phần Xây dựng và Chế biến lương thực Vĩnh Hà
VHG	Công ty Cổ phần Đầu tư Cao Su Quảng Nam
VHH	Công ty cổ phần Đầu tư Kinh doanh nhà Thành Đạt
VHI	CTCP Kinh doanh và Đầu tư Việt Hà
VHL	Công ty Cổ phần Viglacera Hạ Long
VHM	Công ty cổ phần Vinhomes
VIA	Công ty Cổ phần VIAN
VIB	Ngân hàng Thương mại cổ phần Quốc tế Việt Nam
VIC	Tập đoàn Vingroup - Công ty Cổ phần
VIC11501	Trái phiếu Vingroup 062015
VIC11504	Trái phiếu VIC11201802
VID	Công ty Cổ phần Đầu tư Phát triển Thương mại Viễn Đông
VIE	Công ty Cổ phần Công nghệ Viễn thông VITECO
VIF	Tổng Công ty Lâm nghiệp Việt Nam - CTCP
VIG	Công ty Cổ phần Chứng khoán Thương mại và Công nghiệp Việt Nam
VIH	Công ty Cổ phần Viglacera Hà Nội
VIM	Công ty Cổ phần Khoáng sản Viglacera
VIN	CTCP Giao nhận Kho vận Ngoại thương Việt Nam
VIP	Công ty Cổ phần Vận tải Xăng dầu VIPCO
VIR	Công ty cổ phần Du lịch Quốc tế Vũng Tàu
VIS	Công ty Cổ phần Thép Việt Ý
VIT	Công ty Cổ phần Viglacera Tiên Sơn
VIW	Tổng Công ty Đầu tư Nước và Môi trường Việt Nam - CTCP
VIX	Công ty cổ phần Chứng khoán IB
VJC	Công ty cổ phần Hàng không VietJet
VKC	Công ty cổ phần Cáp Nhựa Vĩnh Khánh
VKD	Công ty Cổ phần Nước khoáng Khánh Hòa
VKP	Công ty Cổ phần Nhựa Tân Hóa
VLA	Công ty Cổ phần Đầu tư và Phát triển Công nghệ Văn Lang
VLB	CTCP Xây dựng và Sản xuất Vật liệu Xây dựng Biên Hòa
VLC	Tổng Công ty Chăn nuôi Việt Nam - CTCP
VLF	Công ty Cổ phần Lương thực Thực phẩm Vĩnh Long
VLG	CTCP Vinalines Logistics - Việt Nam
VLP	Công ty Cổ phần Công trình công cộng Vĩnh Long
VLW	Công ty Cổ phần Cấp nước Vĩnh Long
VMA	Công ty cổ phần Công nghiệp Ô tô – Vinacomin
VMC	Công ty Cổ phần Vimeco
VMD	Công ty cổ phần Y Dược phẩm Vimedimex
VMG	Công ty Cổ phần Thương mại và Dịch vụ Dầu khí Vũng Tàu
VMI	Công ty Cổ phần Khoáng sản và Đầu tư VISACO
VMS	CTCP Phát triển Hàng hải
VNA	Công ty Cổ phần Vận tải Biển Vinaship
VNB	CTCP Sách Việt Nam
VNC	Công ty Cổ phần Tập đoàn Vinacontrol
VND	Công ty cổ phần Chứng khoán VNDIRECT
VNE	Tổng công ty Cổ phần Xây dựng điện Việt Nam
VNF	Công ty cổ phần Vinafreight
VNG	Công ty Cổ phần Du lịch Thành Thành Công
VNH	Công ty Cổ phần Đầu tư Việt Việt Nhật
VNI	Công ty cổ phần Đầu tư Bất động sản Việt Nam
VNL	Công ty cổ phần Logistics Vinalink
VNM	Công ty Cổ phần Sữa Việt Nam
VNN	Công ty cổ phần Đầu tư và Thương mại VNN
VNP	Công ty cổ phần Nhựa Việt Nam
VNR	Tổng Công ty Cổ phần Tái bảo hiểm quốc gia Việt Nam
VNS	Công ty Cổ phần Ánh Dương Việt Nam
VNT	Công ty cổ phần Giao nhận Vận tải Ngoại thương
VNX	Công ty Cổ phần Quảng cáo và Hội chợ Thương mại
VNY	Công ty Cổ phần Thuốc Thú y Trung ương I
VOC	Tổng Công ty Công nghiệp Dầu thực vật Việt Nam - CTCP
VOS	Công ty Cổ phần Vận tải biển Việt Nam
VPA	CTCP Vận tải Hóa dầu VP
VPB	Ngân hàng Thương mại Cổ phần Việt Nam Thịnh Vượng
VPC	Công ty Cổ phần Đầu tư và Phát triển Năng lượng Việt Nam
VPD	Công ty cổ phần Phát triển Điện lực Việt Nam
VPG	Công ty Cổ phần Đầu tư Thương mại Xuất nhập khẩu Việt Phát
VPH	Công ty Cổ phần Vạn Phát Hưng
VPI	Công ty Cổ phần Đầu tư Văn Phú - Invest
VPK	Công ty Cổ phần Bao bì dầu thực vật
VPL	Công ty TNHH Một thành viên Vinpearl
VPR	CTCP In và Thương mại Vina
VPS	CTCP Thuốc sát trùng Việt Nam
VPW	Công ty Cổ phần Cấp thoát nước số 1 Vĩnh Phúc
VQC	Công ty Cổ phần Giám định Vinacomin
VRC	Công ty Cổ phần Bất động sản và Đầu tư VRC
VRE	Công ty Cổ phần Vincom Retail
VRG	CTCP Phát triển đô thị và Khu công nghiệp Cao su Việt Nam
VSA	Công ty cổ phần Đại lý Hàng hải Việt Nam
VSC	Công ty cổ phần Tập đoàn Container Việt Nam
VSE	Công ty cổ phần Dịch vụ Đường cao tốc Việt Nam
VSF	Tổng Công ty Lương thực Miền Nam - Công ty cổ phần
VSG	Công ty Cổ phần Container Phía Nam
VSH	Công ty Cổ phần Thủy điện Vĩnh Sơn - Sông Hinh
VSI	Công ty Cổ phần Đầu tư và Xây dựng Cấp thoát nước
VSM	Công ty Cổ phần Container Miền Trung
VSN	CTCP Việt Nam Kỹ nghệ Súc sản
VSP	Công ty cổ phần Vận tải biển và Bất động sản Việt Hải
VST	Công ty Cổ phần Vận tải và Thuê tàu biển Việt Nam
VT1	Công ty Cổ phần Vật tư Bến Thành
VT8	Công ty Cổ phần Dịch vụ Vận tải ô tô số 8
VTA	Công ty Cổ phần Vitaly
VTB	Công ty Cổ phần Viettronics Tân Bình
VTC	Công ty Cổ phần Viễn thông VTC
VTD	Công ty cổ phần Du lịch Vietourist
VTE	Công ty cổ phần Viễn thông Điện tử Vinacap
VTF	Công ty Cổ phần Thức ăn Chăn nuôi Việt Thắng
VTG	Công ty cổ phần Du lịch tỉnh Bà Rịa - Vũng Tàu
VTH	Công ty Cổ phần Dây cáp điện Việt Thái
VTI	Công ty Cổ phần Sản xuất – Xuất nhập khẩu Dệt May
VTJ	Công ty cổ phần Thương mại và Đầu tư Vinataba
VTK	Công ty cổ phần Tư vấn Thiết kế Viettel
VTL	Công ty Cổ phần Vang Thăng Long
VTM	CTCP Vận tải và Đưa đón thợ mỏ - Vinacomin
VTO	Công ty Cổ phần Vận tải Xăng dầu VITACO
VTP	Tổng CTCP Bưu chính Viettel
VTR	CTCP Du lịch và Tiếp thị Giao thông Vận tải Việt Nam - Vietravel
VTS	Công ty Cổ phần Viglacera Từ Sơn
VTV	Công ty Cổ phần VICEM Vật tư Vận tải Xi măng
VTX	Công ty cổ phần Vận tải đa phương thức Vietranstimex
VVN	Tổng Công ty cổ phần Xây dựng công nghiệp Việt Nam
VW3	Công ty cổ phần Viwaseen3
VWS	Công ty Cổ phần Nước và Môi trường Việt Nam
VXB	Công ty Cổ phần Vật liệu xây dựng Bến Tre
VXP	CTCP Thuốc Thú y Trung ương VETVACO
WCS	Công ty Cổ phần Bến xe Miền Tây
WSB	Công ty Cổ phần Bia Sài Gòn - Miền Tây
WSS	Công ty Cổ phần Chứng khoán Phố Wall
WTC	CTCP Vận tải thủy - Vinacomin
WTN	Công ty Cổ phần Cấp thoát nước Tây Ninh
X18	Công ty Cổ phần Xi măng X18
X20	Công ty Cổ phần X20
X26	Công ty cổ phần 26
X77	Công ty Cổ phần Thành An 77
XDH	Công ty cổ phần Đầu tư Xây dưng Dân dụng Hà Nội
XHC	Công ty cổ phần Xuân Hòa Việt Nam
XLV	Công ty Cổ phần Xây lắp và Dịch vụ Sông Đà
XMC	Công ty cổ phần Đầu tư và Xây dựng Xuân Mai
XMD	Công ty cổ phần Xuân Mai - Đạo Tú
XPH	Công ty Cổ phần Xà phòng Hà Nội
YBC	Công ty Cổ phần Xi măng và Khoáng sản Yên Bái
YBM	Công ty Cổ phần Khoáng sản Công nghiệp Yên Bái
YEG	Công ty Cổ phần Tập đoàn Yeah1
YRC	CTCP Đường sắt Yên Lào
YSC	Công ty Cổ phần Hapaco Yên Sơn
YTC	Công ty Cổ phần Xuất nhập khẩu Y tế Thành phố Hồ Chí Minh
